task_id,user_id,server_id,generation_time,completion_time,latency
7,11,4,0,18,18
22,18,4,1,18,17
24,20,4,1,18,17
1,1,0,0,35,35
4,6,0,0,35,35
10,14,0,0,35,35
11,15,0,0,35,35
23,19,0,1,35,34
27,29,0,1,35,34
9,13,2,0,35,35
12,21,2,0,35,35
14,28,2,0,35,35
18,2,2,1,35,34
28,31,2,1,35,34
3,5,3,0,35,35
5,7,3,0,35,35
15,30,3,0,35,35
16,32,3,0,35,35
17,33,3,0,35,35
20,9,3,1,35,34
21,17,3,1,35,34
26,26,3,1,35,34
0,0,1,0,36,36
2,3,1,0,36,36
6,10,1,0,36,36
8,12,1,0,36,36
13,24,1,0,36,36
19,4,1,1,36,35
25,22,1,1,36,35
60,1,0,38,43,5
63,4,0,41,50,9
29,25,2,12,70,58
34,11,2,19,70,51
35,20,2,19,70,51
37,23,2,21,70,49
40,7,2,36,70,34
45,17,2,36,70,34
30,27,1,14,71,57
31,8,1,16,71,55
33,34,1,17,71,54
36,18,1,20,71,51
48,28,1,36,71,35
49,29,1,36,71,35
50,30,1,36,71,35
51,31,1,36,71,35
38,2,4,36,71,35
39,6,4,36,71,35
42,13,4,36,71,35
43,14,4,36,71,35
44,15,4,36,71,35
46,21,4,36,71,35
52,33,4,36,71,35
54,3,4,37,71,34
32,16,3,16,73,57
41,9,3,36,73,37
47,26,3,36,73,37
56,10,3,37,73,36
57,19,3,37,73,36
59,32,3,37,73,36
61,12,3,39,73,34
62,22,3,39,73,34
70,3,2,72,79,7
95,33,2,83,88,5
96,33,2,97,106,9
97,3,2,98,106,8
55,5,4,37,106,69
64,1,4,54,106,52
67,17,4,71,106,35
69,23,4,71,106,35
71,8,4,72,106,34
73,14,4,72,106,34
74,15,4,72,106,34
75,25,4,72,106,34
53,0,1,37,107,70
58,24,1,37,107,70
65,4,1,54,107,53
66,7,1,71,107,36
78,30,1,72,107,35
79,34,1,72,107,35
80,2,1,73,107,34
84,31,1,73,107,34
76,27,3,72,110,38
82,13,3,73,110,37
83,21,3,73,110,37
85,19,3,74,110,36
86,26,3,74,110,36
89,16,3,75,110,35
90,18,3,75,110,35
92,22,3,76,110,34
68,20,0,71,111,40
72,11,0,72,111,39
81,6,0,73,111,38
87,10,0,75,111,36
88,12,0,75,111,36
77,28,4,72,126,54
99,3,4,107,126,19
101,14,4,107,126,19
112,4,4,109,126,17
104,23,2,107,127,20
107,2,2,108,127,19
109,30,2,108,127,19
122,26,4,111,131,20
91,9,1,76,142,66
94,32,1,77,142,65
98,1,1,107,142,35
100,8,1,107,142,35
102,15,1,107,142,35
106,33,1,107,142,35
108,7,1,108,142,34
110,31,1,108,142,34
93,29,3,76,145,69
115,34,3,109,145,36
116,13,3,111,145,34
117,16,3,111,145,34
118,18,3,111,145,34
119,19,3,111,145,34
103,17,0,107,146,39
105,25,0,107,146,39
113,5,0,109,146,37
120,21,0,111,146,35
121,22,0,111,146,35
126,20,0,112,146,34
128,6,2,115,150,35
132,30,2,129,150,21
133,3,2,130,150,20
130,4,0,128,166,38
135,14,0,131,166,35
138,7,0,143,166,23
148,19,0,146,166,20
111,0,1,109,177,68
114,24,1,109,177,68
125,12,1,112,177,65
131,2,1,129,177,48
134,23,1,130,177,47
123,10,3,112,181,69
124,11,3,112,181,69
127,27,3,112,181,69
129,28,3,127,181,54
136,26,3,133,181,48
146,16,3,146,181,35
151,22,3,147,181,34
152,25,3,147,181,34
140,15,4,143,184,41
141,32,4,143,184,41
144,31,4,144,184,40
147,18,4,146,184,38
149,17,4,147,184,37
150,20,4,147,184,37
155,5,4,148,184,36
157,6,0,153,191,38
158,3,0,158,191,33
161,14,0,167,191,24
137,1,2,143,191,48
139,8,2,143,191,48
142,33,2,143,191,48
145,13,2,146,191,45
153,29,2,147,191,44
143,9,1,144,195,51
154,34,1,147,195,48
156,21,1,149,195,46
162,19,1,167,195,28
169,10,2,182,211,29
173,25,2,182,211,29
175,26,2,183,211,28
183,31,2,188,211,23
159,30,3,164,218,54
160,4,3,167,218,51
164,0,3,178,218,40
167,23,3,178,218,40
176,28,3,183,218,35
163,7,4,169,219,50
165,2,4,178,219,41
166,12,4,178,219,41
168,24,4,178,219,41
171,16,4,182,219,37
193,21,2,196,220,24
195,34,2,196,220,24
172,22,0,182,227,45
174,27,0,182,227,45
178,18,0,185,227,42
179,32,0,185,227,42
186,13,0,192,227,35
170,11,1,182,231,49
182,17,1,188,231,43
185,3,1,192,231,39
188,8,1,193,231,38
194,29,1,196,231,35
190,6,4,195,231,36
208,16,4,220,231,11
202,23,2,219,232,13
206,7,2,220,232,12
218,8,4,232,246,14
222,3,4,233,246,13
177,5,3,185,253,68
180,15,3,186,253,67
181,20,3,186,253,67
184,1,3,192,253,61
187,33,3,192,253,61
189,14,3,194,253,59
197,25,3,212,253,41
203,28,3,219,253,34
191,9,0,196,262,66
192,19,0,196,262,66
200,0,0,219,262,43
201,4,0,219,262,43
209,24,0,220,262,42
210,34,0,221,262,41
211,21,0,222,262,40
228,1,4,254,265,11
234,33,4,254,265,11
196,10,1,212,266,54
198,26,1,212,266,54
199,31,1,212,266,54
204,30,1,219,266,47
220,17,1,232,266,34
221,29,1,232,266,34
213,18,2,228,270,42
214,22,2,228,270,42
215,27,2,228,270,42
216,32,2,228,270,42
217,6,2,232,270,38
240,24,4,263,270,7
223,23,1,236,285,49
229,5,1,254,285,31
232,25,1,254,285,31
244,10,1,267,285,18
246,29,4,267,288,21
249,31,4,268,288,20
251,18,4,271,288,17
205,2,3,220,289,69
207,12,3,220,289,69
212,13,3,228,289,61
224,7,3,242,289,47
225,16,3,246,289,43
227,8,3,247,289,42
258,25,1,286,291,5
219,11,0,232,301,69
226,3,0,247,301,54
230,14,0,254,301,47
231,20,0,254,301,47
236,0,0,263,301,38
243,1,0,267,301,34
265,7,1,290,301,11
267,12,1,290,301,11
233,28,2,254,305,51
235,15,2,255,305,50
238,19,2,263,305,42
239,21,2,263,305,42
241,9,2,264,305,41
242,34,2,266,305,39
245,26,2,267,305,38
250,33,2,268,305,37
257,23,4,286,306,20
259,5,4,287,306,19
262,29,4,289,306,17
272,7,1,302,311,9
276,1,1,303,311,8
289,29,1,308,319,11
237,4,3,263,324,61
247,30,3,267,324,57
248,17,3,268,324,56
252,22,3,271,324,53
260,10,3,287,324,37
261,18,3,289,324,35
269,16,3,290,324,34
264,2,4,290,324,34
266,8,4,290,324,34
280,15,4,306,324,18
285,34,4,306,324,18
292,29,1,320,327,7
295,8,1,325,335,10
255,6,0,272,337,65
268,13,0,290,337,47
274,12,0,302,337,35
275,20,0,302,337,35
278,14,0,303,337,34
253,27,2,271,340,69
254,32,2,271,340,69
256,24,2,278,340,62
263,31,2,289,340,51
271,0,2,302,340,38
273,11,2,302,340,38
277,3,2,303,340,37
279,9,2,306,340,34
293,2,4,325,343,18
296,10,4,325,343,18
301,22,4,325,343,18
302,30,4,325,343,18
305,6,1,338,348,10
306,14,1,338,348,10
270,25,3,301,361,60
283,28,3,306,361,55
286,5,3,307,361,54
294,4,3,325,361,36
297,15,3,325,361,36
298,16,3,325,361,36
299,17,3,325,361,36
307,13,4,339,363,24
308,20,4,339,363,24
310,9,4,341,363,22
314,31,4,341,363,22
313,27,1,341,366,25
317,12,1,342,366,24
322,2,1,345,366,21
281,19,0,306,374,68
282,26,0,306,374,68
287,21,0,307,374,67
290,7,0,313,374,61
291,1,0,314,374,60
303,34,0,325,374,49
284,33,2,306,378,72
288,23,2,307,378,71
300,18,2,325,378,53
309,3,2,341,378,37
316,0,2,342,378,36
318,8,2,343,378,35
319,10,2,344,378,34
321,30,2,344,378,34
304,29,3,333,380,47
312,24,3,341,380,39
329,17,3,362,380,18
330,25,3,362,380,18
325,4,4,362,381,19
326,5,4,362,381,19
332,20,4,364,381,17
324,6,1,355,384,29
331,28,1,362,384,22
337,12,1,367,384,17
338,27,1,367,384,17
327,15,2,362,387,25
334,9,2,365,387,22
357,17,2,382,392,10
311,11,0,341,409,68
315,32,0,341,409,68
320,22,0,344,409,65
323,14,0,353,409,56
328,16,0,362,409,47
336,2,0,367,409,42
340,7,0,375,409,34
344,34,0,375,409,34
335,13,4,365,416,51
342,21,4,375,416,41
346,3,4,379,416,37
347,8,4,379,416,37
353,24,4,381,416,35
354,25,4,381,416,35
355,29,4,381,416,35
333,31,3,364,417,53
341,19,3,375,417,42
343,26,3,375,417,42
349,23,3,379,417,38
350,30,3,379,417,38
339,1,1,375,421,46
348,18,1,379,421,42
351,33,1,379,421,42
352,10,1,380,421,41
356,4,1,382,421,39
367,2,2,410,421,11
373,34,2,411,421,10
374,16,4,412,425,13
379,24,4,417,425,8
378,21,2,417,433,16
388,4,2,422,433,11
386,31,4,418,435,17
387,1,4,422,435,13
397,31,4,437,442,5
345,0,0,379,444,65
358,28,0,385,444,59
359,20,0,387,444,57
361,15,0,394,444,50
364,5,0,399,444,45
365,27,0,401,444,43
366,17,0,402,444,42
368,7,0,410,444,34
398,1,4,439,448,9
362,9,1,395,456,61
363,12,1,396,456,60
372,22,1,411,456,45
382,19,1,418,456,38
390,18,1,422,456,34
360,6,3,390,456,66
370,14,3,410,456,46
375,3,3,417,456,39
380,25,3,417,456,39
381,29,3,417,456,39
383,23,3,418,456,38
384,26,3,418,456,38
389,10,3,422,456,34
413,10,4,457,462,5
399,4,2,444,463,19
404,27,2,445,463,18
405,28,2,445,463,18
406,31,2,445,463,18
411,6,2,457,468,11
424,31,2,466,477,11
426,10,2,468,477,9
369,11,0,410,479,69
371,32,0,410,479,69
376,8,0,417,479,62
377,13,0,417,479,62
385,30,0,418,479,61
392,33,0,423,479,56
394,16,0,431,479,48
395,24,0,435,479,44
425,27,4,467,484,17
437,13,4,481,489,8
393,2,1,431,491,60
402,15,1,445,491,46
403,20,1,445,491,46
409,1,1,451,491,40
410,3,1,457,491,34
414,12,1,457,491,34
418,22,1,457,491,34
422,29,1,457,491,34
391,34,3,422,491,69
396,21,3,437,491,54
400,0,3,445,491,46
407,5,3,446,491,45
408,17,3,446,491,45
412,9,3,457,491,34
415,14,3,457,491,34
417,19,3,457,491,34
439,27,4,486,494,8
401,7,0,445,497,52
416,18,0,457,497,40
419,23,0,457,497,40
428,6,0,474,497,23
429,10,2,479,504,25
435,32,2,480,504,24
438,24,2,481,504,23
444,5,4,492,517,25
449,20,4,492,517,25
454,14,4,494,517,23
457,6,4,498,517,19
447,17,2,492,522,30
458,7,2,498,522,24
460,23,2,498,522,24
431,8,1,480,526,46
434,30,1,480,526,46
436,33,1,480,526,46
443,2,1,492,526,34
446,12,1,492,526,34
450,21,1,492,526,34
420,25,3,457,526,69
421,26,3,457,526,69
423,4,3,466,526,60
427,28,3,469,526,57
430,31,3,479,526,47
432,11,3,480,526,46
433,16,3,480,526,46
452,29,3,492,526,34
440,13,0,491,532,41
441,0,0,492,532,40
442,1,0,492,532,40
445,9,0,492,532,40
448,19,0,492,532,40
451,22,0,492,532,40
453,34,0,492,532,40
455,3,0,495,532,37
472,4,4,527,538,11
475,21,4,527,538,11
471,7,2,525,545,20
476,25,2,527,545,18
482,33,2,527,545,18
489,13,4,533,551,18
490,19,4,533,551,18
495,25,2,548,554,6
498,33,4,550,556,6
459,18,3,498,562,64
461,27,3,500,562,62
463,10,3,507,562,55
464,32,3,508,562,54
465,5,3,518,562,44
468,20,3,518,562,44
469,23,3,523,562,39
483,8,3,528,562,34
499,13,2,552,563,11
500,19,2,553,563,10
456,15,1,497,564,67
462,24,1,506,564,58
466,6,1,518,564,46
470,17,1,524,564,40
474,16,1,527,564,37
478,28,1,527,564,37
480,30,1,527,564,37
485,2,1,530,564,34
467,14,0,518,570,52
473,12,0,527,570,43
477,26,0,527,570,43
479,29,0,527,570,43
481,31,0,527,570,43
487,3,0,533,570,37
491,22,0,533,570,37
509,27,2,563,582,19
511,19,2,564,582,18
518,28,2,565,582,17
507,20,4,563,585,22
514,15,4,565,585,20
520,6,4,566,585,19
522,12,2,571,587,16
488,9,1,533,599,66
492,34,1,533,599,66
497,21,1,549,599,50
503,5,1,563,599,36
504,8,1,563,599,36
510,32,1,563,599,36
513,13,1,565,599,34
517,24,1,565,599,34
484,11,3,528,601,73
486,1,3,533,601,68
493,0,3,534,601,67
496,7,3,549,601,52
501,25,3,555,601,46
506,18,3,563,601,38
523,14,4,571,604,33
530,6,4,586,604,18
532,28,4,586,604,18
494,4,0,547,605,58
502,33,0,558,605,47
505,10,0,563,605,42
508,23,0,563,605,42
512,2,0,565,605,40
515,16,0,565,605,40
516,17,0,565,605,40
519,30,0,565,605,40
544,7,2,602,609,7
551,4,2,606,619,13
554,23,2,606,619,13
559,28,2,614,626,12
560,7,2,626,631,5
527,31,1,571,636,65
531,20,1,586,636,50
534,12,1,588,636,48
536,8,1,600,636,36
541,24,1,601,636,35
545,11,1,602,636,34
547,25,1,602,636,34
521,3,3,571,639,68
525,26,3,571,639,68
526,29,3,571,639,68
529,19,3,585,639,54
533,15,3,587,639,52
538,21,3,600,639,39
546,18,3,602,639,37
550,32,3,605,639,34
535,5,4,600,641,41
537,9,4,600,641,41
539,34,4,600,641,41
542,0,4,602,641,39
548,6,4,605,641,36
555,30,4,606,641,35
524,22,0,571,642,71
528,27,0,584,642,58
540,13,0,601,642,41
543,1,0,602,642,40
549,14,0,605,642,37
552,10,0,606,642,36
557,17,0,607,642,35
553,16,1,606,646,40
567,12,1,637,646,9
562,4,2,630,646,16
569,24,2,637,646,9
588,27,1,643,657,14
592,14,1,647,657,10
556,33,3,606,675,69
558,2,3,613,675,62
566,11,3,637,675,38
570,25,3,637,675,38
573,15,3,640,675,35
575,19,3,640,675,35
598,14,1,663,676,13
561,23,0,626,677,51
564,7,0,634,677,43
565,8,0,637,677,40
568,20,0,637,677,40
571,31,0,637,677,40
578,29,0,640,677,37
581,9,0,642,677,35
583,1,0,643,677,34
563,28,4,631,677,46
574,18,4,640,677,37
576,21,4,640,677,37
577,26,4,640,677,37
579,32,4,641,677,36
582,30,4,642,677,35
587,22,4,643,677,34
572,3,2,640,688,48
580,0,2,642,688,46
584,5,2,643,688,45
585,6,2,643,688,45
589,34,2,643,688,45
593,16,2,650,688,38
586,13,3,643,693,50
591,10,3,645,693,48
597,24,3,661,693,32
605,15,1,677,696,19
608,8,1,678,696,18
609,9,1,678,696,18
599,2,4,676,712,36
601,19,4,676,712,36
602,25,4,676,712,36
606,1,4,678,712,34
611,20,4,678,712,34
590,17,0,644,714,70
594,12,0,655,714,59
595,27,0,658,714,56
603,33,0,676,714,38
613,28,0,678,714,36
623,6,1,689,716,27
626,5,1,690,716,26
629,24,1,694,716,22
632,8,1,702,725,23
639,17,1,715,725,10
596,4,2,659,725,66
600,11,2,676,725,49
610,18,2,678,725,47
612,22,2,678,725,47
614,29,2,678,725,47
615,30,2,678,725,47
625,34,2,689,725,36
604,14,3,677,728,51
607,7,3,678,728,50
616,31,3,678,728,50
617,23,3,679,728,49
618,26,3,679,728,49
619,21,3,680,728,48
620,32,3,680,728,48
621,0,3,689,728,39
627,10,2,694,743,49
638,12,2,715,743,28
641,28,2,715,743,28
647,8,2,726,743,17
622,3,0,689,752,63
630,9,0,698,752,54
631,15,0,698,752,54
634,19,0,713,752,39
635,20,0,713,752,39
645,24,0,717,752,35
649,17,0,726,761,35
667,3,0,753,761,8
633,1,4,713,761,48
636,25,4,713,761,48
640,27,4,715,761,46
642,33,4,715,761,46
643,5,4,717,761,44
644,6,4,717,761,44
651,30,4,726,761,35
654,29,2,727,762,35
659,26,2,729,762,33
661,32,2,729,762,33
624,16,3,689,763,74
628,13,3,694,763,69
637,2,3,714,763,49
653,18,3,727,763,36
657,21,3,729,763,34
658,23,3,729,763,34
646,4,1,726,765,39
648,11,1,726,765,39
650,22,1,726,765,39
652,34,1,726,765,39
656,14,1,729,765,36
688,23,0,764,774,10
689,4,0,766,774,8
693,11,0,767,780,13
696,4,0,781,796,15
655,0,4,729,797,68
660,31,4,729,797,68
669,19,4,753,797,44
671,15,4,754,797,43
672,24,4,755,797,42
673,1,4,762,797,35
677,30,4,762,797,35
680,25,4,763,797,34
668,9,2,753,798,45
675,5,2,762,798,36
676,6,2,762,798,36
678,33,2,762,798,36
681,26,2,763,798,35
682,27,2,763,798,35
684,32,2,763,798,35
687,16,2,764,798,34
662,7,3,730,798,68
663,10,3,744,798,54
665,28,3,747,798,51
666,8,3,748,798,50
674,3,3,762,798,36
679,17,3,763,798,35
664,12,1,744,800,56
670,20,1,753,800,47
683,29,1,763,800,37
685,2,1,764,800,36
690,14,1,766,800,34
686,13,4,764,832,68
701,1,4,798,832,34
703,19,4,798,832,34
704,24,4,798,832,34
705,25,4,798,832,34
692,22,2,766,833,67
699,4,2,797,833,36
708,3,2,799,833,34
710,8,2,799,833,34
712,10,2,799,833,34
716,27,2,799,833,34
691,18,3,766,833,67
695,34,3,771,833,62
697,11,3,784,833,49
698,23,3,784,833,49
709,5,3,799,833,34
694,21,1,768,835,67
711,9,1,799,835,36
713,16,1,799,835,36
715,26,1,799,835,36
717,28,1,799,835,36
718,6,1,800,835,35
723,29,1,801,835,34
700,0,0,798,837,39
702,15,0,798,837,39
706,30,0,798,837,39
707,31,0,798,837,39
714,17,0,799,837,38
719,7,0,800,837,37
721,2,0,801,837,36
720,33,3,800,851,51
731,3,3,834,851,17
735,10,3,834,851,17
722,12,4,801,851,50
727,13,4,833,851,18
732,4,4,834,851,17
725,14,1,802,870,68
729,25,1,833,870,37
737,18,1,834,870,36
738,23,1,834,870,36
739,24,1,834,870,36
741,34,1,834,870,36
744,9,1,836,870,34
745,16,3,836,870,34
755,17,3,840,870,30
756,15,3,841,870,29
758,10,3,852,870,18
728,19,0,833,872,39
733,5,0,834,872,38
734,8,0,834,872,38
740,27,0,834,872,38
750,0,0,838,872,34
751,7,0,838,872,34
724,32,2,801,872,71
726,20,2,802,872,70
730,1,2,834,872,38
736,11,2,834,872,38
746,26,2,836,872,36
749,21,2,837,872,35
752,30,2,838,872,34
742,22,4,835,891,56
743,6,4,836,891,55
747,28,4,836,891,55
748,29,4,836,891,55
753,2,4,839,891,52
757,3,4,852,891,39
774,11,2,873,892,19
779,5,2,874,892,18
781,32,2,875,892,17
784,30,4,876,900,24
789,6,4,892,900,8
759,12,1,852,906,54
760,13,1,852,906,54
761,33,1,852,906,54
765,17,1,871,906,35
769,25,1,871,906,35
795,32,4,896,906,10
763,9,3,871,907,36
766,18,3,871,907,36
767,23,3,871,907,36
770,34,3,871,907,36
771,15,3,872,907,35
772,1,3,873,907,34
773,10,3,873,907,34
775,14,3,873,907,34
754,31,0,839,908,69
762,4,0,853,908,55
764,16,0,871,908,37
768,24,0,871,908,37
777,21,0,873,908,35
778,26,0,873,908,35
783,19,2,876,910,34
786,27,2,878,910,32
792,11,2,893,910,17
793,29,0,894,918,24
805,9,0,908,918,10
819,27,0,914,923,9
788,3,1,892,925,33
791,28,1,892,925,33
794,5,1,895,925,30
806,10,1,908,925,17
822,27,0,924,935,11
824,5,0,926,935,9
776,20,3,873,942,69
780,0,3,875,942,67
782,8,3,876,942,66
785,7,3,878,942,64
787,2,3,892,942,50
790,22,3,892,942,50
797,30,3,901,942,41
800,17,3,907,942,35
798,12,4,907,943,36
803,33,4,907,943,36
804,1,4,908,943,35
807,14,4,908,943,35
810,23,4,908,943,35
812,4,4,909,943,34
796,6,2,901,945,44
799,13,2,907,945,38
802,32,2,907,945,38
811,34,2,908,945,37
814,24,2,909,945,36
816,19,2,911,945,34
815,31,1,909,963,54
817,26,1,911,963,52
820,29,1,919,963,44
821,11,1,921,963,42
825,9,1,926,963,37
818,21,2,912,963,51
828,5,2,936,963,27
840,14,2,944,963,19
841,23,2,944,963,19
844,19,2,947,968,21
801,25,3,907,977,70
808,15,3,908,977,69
809,18,3,908,977,69
813,16,3,909,977,68
827,28,3,926,977,51
830,0,3,943,977,34
833,20,3,943,977,34
823,3,4,926,978,52
826,10,4,926,978,52
831,7,4,943,978,35
832,17,4,943,978,35
834,22,4,943,978,35
836,2,4,944,978,34
838,8,4,944,978,34
839,12,4,944,978,34
835,30,0,943,983,40
843,24,0,946,983,37
845,34,0,947,983,36
846,6,0,948,983,35
847,33,0,949,983,34
837,4,3,944,996,52
842,1,3,946,996,50
864,28,3,978,996,18
870,17,3,979,996,17
