task_id,user_id,server_id,generation_time,completion_time,latency
1,2,4,0,9,9
10,12,4,0,9,9
0,1,0,0,18,18
7,8,0,0,18,18
11,13,0,0,18,18
2,3,2,0,18,18
3,4,2,0,18,18
5,6,2,0,18,18
8,10,2,0,18,18
4,5,3,0,18,18
6,7,3,0,18,18
9,11,3,0,18,18
12,14,3,0,18,18
14,9,4,10,19,9
15,12,4,10,19,9
13,0,0,5,27,22
23,8,0,19,27,8
21,6,1,19,28,9
27,14,1,19,28,9
17,1,4,19,28,9
19,4,4,19,28,9
29,12,0,24,35,11
16,2,3,13,36,23
18,3,3,19,36,17
22,7,3,19,36,17
24,10,3,19,36,17
20,5,2,19,37,18
25,11,2,19,37,18
26,13,2,19,37,18
33,6,1,29,38,9
35,14,1,29,38,9
39,3,0,38,43,5
36,7,1,37,47,10
42,13,1,38,47,9
30,0,4,29,47,18
31,1,4,29,47,18
34,8,4,29,47,18
51,13,1,48,53,5
28,9,2,24,55,31
32,4,2,29,55,26
37,10,2,37,55,18
41,12,2,38,55,17
46,3,0,46,56,10
48,1,0,48,56,8
38,2,3,38,56,18
40,5,3,38,56,18
44,14,3,39,56,17
49,7,4,48,57,9
50,8,4,48,57,9
54,12,1,56,65,9
55,1,1,57,65,8
63,7,4,60,65,5
43,6,2,39,73,34
47,0,2,48,73,25
52,9,2,56,73,17
53,10,0,56,74,18
56,2,0,57,74,17
58,4,0,57,74,17
59,5,0,57,74,17
45,11,3,40,74,34
57,3,3,57,74,17
60,13,3,57,74,17
61,14,3,57,74,17
62,8,1,59,75,16
66,1,1,67,75,8
68,9,4,74,79,5
77,14,1,75,80,5
64,7,2,66,82,16
67,0,2,74,82,8
78,1,1,80,89,9
79,8,1,80,89,9
81,0,4,85,90,5
74,10,2,75,91,16
80,9,2,80,91,11
69,2,3,75,93,18
75,11,3,75,93,18
76,13,3,75,93,18
82,7,1,86,94,8
85,0,4,92,97,5
84,14,3,90,102,12
88,1,3,93,102,9
92,11,2,98,103,5
91,2,4,98,103,5
94,14,2,103,108,5
65,12,0,66,109,43
70,3,0,75,109,34
71,4,0,75,109,34
72,5,0,75,109,34
73,6,0,75,109,34
86,9,1,92,113,21
87,10,1,92,113,21
90,7,1,95,113,18
97,2,2,107,113,6
95,1,3,105,114,9
96,11,3,105,114,9
102,3,2,114,119,5
98,5,4,110,120,10
101,4,4,112,120,8
108,11,2,119,124,5
109,2,4,121,126,5
83,8,0,90,127,37
89,13,0,94,127,33
93,0,0,102,127,25
112,5,2,126,131,5
100,14,1,111,132,21
105,12,1,114,132,18
106,1,1,115,132,17
99,6,3,110,132,22
103,7,3,114,132,18
104,9,3,114,132,18
113,11,4,127,132,5
110,3,0,121,136,15
111,4,0,121,136,15
123,12,1,133,142,9
125,14,1,133,142,9
127,4,4,137,142,5
114,2,0,132,145,13
126,3,0,137,145,8
129,12,1,143,148,5
128,4,4,143,152,9
130,14,4,143,152,9
133,12,0,151,156,5
136,12,4,157,162,5
134,4,0,153,165,12
135,14,0,153,165,12
107,10,3,116,167,51
115,5,3,132,167,35
116,0,3,133,167,34
117,1,3,133,167,34
118,6,3,133,167,34
119,7,2,133,168,35
120,8,2,133,168,35
121,9,2,133,168,35
122,11,2,133,168,35
124,13,2,133,168,35
144,7,0,169,174,5
138,4,1,166,175,9
139,14,1,166,175,9
132,3,2,148,177,29
147,11,2,169,177,8
141,5,4,168,177,9
146,9,4,169,177,8
149,7,0,175,180,5
140,0,1,168,180,12
154,11,1,178,185,7
131,2,3,147,185,38
137,12,3,163,185,22
142,6,3,168,185,17
143,10,3,168,185,17
150,4,2,176,187,11
155,14,2,178,187,9
152,3,4,178,187,9
153,5,4,178,187,9
159,6,0,186,191,5
156,0,2,181,192,11
163,12,4,187,192,5
170,12,4,194,199,5
168,0,2,194,200,6
157,7,1,183,203,20
160,9,1,186,203,17
161,10,1,186,203,17
162,11,1,186,203,17
145,8,3,169,203,34
148,13,3,169,203,34
151,1,3,178,203,25
158,2,3,186,203,17
172,0,4,201,206,5
164,3,0,188,209,21
166,14,0,188,209,21
167,5,0,192,209,17
175,7,2,204,209,5
176,8,4,204,211,7
165,4,3,188,221,33
169,6,3,194,221,27
177,9,3,204,221,17
173,1,1,204,222,18
174,2,1,204,222,18
179,13,1,204,222,18
186,14,4,217,223,6
171,12,0,200,227,27
178,10,0,204,227,23
180,11,0,209,227,18
181,0,2,210,228,18
182,3,2,210,228,18
184,7,2,210,228,18
183,5,3,210,230,20
187,9,3,222,230,8
192,13,0,225,232,7
189,4,1,223,232,9
190,6,1,223,232,9
188,2,4,223,233,10
191,1,4,225,233,8
185,8,2,217,237,20
193,14,2,225,237,12
194,3,4,230,238,8
201,0,1,233,242,9
204,13,1,233,242,9
206,2,4,238,243,5
197,12,2,230,246,16
207,14,2,238,246,8
208,0,1,243,248,5
196,11,3,230,248,18
198,5,3,231,248,17
199,9,3,231,248,17
200,10,3,231,248,17
195,7,0,230,250,20
202,4,0,233,250,17
203,6,0,233,250,17
209,3,4,244,253,9
211,8,4,245,253,8
215,5,2,249,254,5
212,14,3,247,254,7
221,10,4,253,262,9
222,4,4,254,262,8
219,6,3,253,263,10
220,7,3,253,263,10
225,14,2,261,266,5
213,0,1,249,267,18
216,9,1,249,267,18
218,12,1,249,267,18
205,1,0,238,268,30
210,13,0,244,268,24
214,2,0,249,268,19
217,11,0,249,268,19
227,6,4,264,269,5
226,5,2,264,271,7
223,3,0,256,277,21
224,8,0,258,277,19
238,4,4,272,277,5
234,1,2,269,280,11
235,2,2,269,280,11
228,7,1,264,285,21
229,10,1,264,285,21
231,0,1,268,285,17
230,14,3,267,285,18
232,9,3,268,285,17
233,12,3,268,285,17
239,5,4,274,286,12
241,3,4,278,286,8
245,2,0,282,288,6
237,13,1,269,290,21
247,7,4,286,295,9
249,10,4,286,295,9
254,13,1,292,297,5
242,4,2,278,298,20
243,1,2,281,298,17
244,8,2,281,298,17
236,11,3,269,303,34
240,6,3,275,303,28
248,9,3,286,303,17
257,1,1,299,304,5
255,2,4,293,305,12
256,7,4,296,305,9
246,0,0,286,306,20
250,12,0,286,306,20
251,14,0,286,306,20
262,11,1,304,309,5
261,10,3,304,313,9
264,9,3,305,313,8
258,4,4,299,314,15
263,1,4,305,314,9
252,3,0,292,315,23
266,12,0,307,315,8
253,5,2,292,316,24
259,8,2,299,316,17
260,13,2,299,316,17
265,2,1,306,318,12
267,14,1,307,318,11
270,6,3,314,319,5
277,7,4,317,323,6
268,11,2,311,325,14
278,8,2,317,325,8
273,3,3,316,328,12
279,12,3,317,328,11
269,0,0,314,333,19
272,10,0,314,333,19
274,4,0,316,333,17
281,13,4,321,333,12
282,7,4,324,333,9
283,14,2,324,334,10
284,8,2,326,334,8
287,6,3,330,335,5
271,9,1,314,336,22
275,1,1,317,336,19
276,5,1,317,336,19
286,12,0,329,338,9
298,14,0,337,343,6
290,4,2,334,343,9
293,13,2,334,343,9
280,2,1,320,345,25
285,11,1,329,345,16
294,1,2,337,352,15
296,6,2,337,352,15
289,3,4,334,352,18
291,7,4,334,352,18
292,10,4,334,352,18
303,11,0,347,353,6
299,12,1,344,354,10
302,14,1,345,354,9
288,0,3,334,354,20
295,5,3,337,354,17
297,9,3,337,354,17
300,4,2,345,361,16
308,6,2,353,361,8
309,7,3,353,363,10
312,5,3,355,363,8
318,4,2,364,369,5
301,13,4,345,370,25
304,8,4,352,370,18
305,1,4,353,370,17
307,3,4,353,370,17
310,10,0,354,372,18
314,11,0,355,372,17
316,14,0,355,372,17
306,2,1,353,372,19
311,0,1,355,372,17
313,9,1,355,372,17
315,12,1,355,372,17
319,7,3,364,373,9
320,5,3,365,373,8
323,8,4,371,376,5
325,1,2,372,377,5
321,3,1,371,381,10
326,0,1,373,381,8
331,12,2,376,382,6
324,13,3,371,382,11
328,9,3,373,382,9
330,7,4,376,385,9
332,5,4,377,385,8
334,0,3,382,387,5
338,9,2,383,388,5
317,6,0,362,391,29
322,4,0,371,391,20
327,2,0,373,391,18
337,10,4,382,394,12
340,12,4,385,394,9
336,8,0,382,396,14
345,6,2,392,397,5
342,5,3,389,398,9
343,13,3,390,398,8
329,11,1,374,399,25
333,14,1,381,399,18
335,3,1,382,399,17
348,10,0,395,406,11
349,12,0,395,406,11
347,2,3,395,407,12
351,6,3,399,407,8
339,1,1,384,408,24
350,9,1,397,408,11
352,13,2,399,408,9
353,14,2,400,408,8
341,7,4,388,412,24
344,4,4,392,412,20
346,0,4,395,412,17
357,6,0,408,417,9
364,14,0,409,417,8
366,4,2,413,422,9
367,7,2,413,422,9
369,6,0,418,423,5
356,11,3,407,425,18
358,10,3,408,425,17
359,12,3,408,425,17
371,4,0,424,429,5
370,14,3,423,430,7
362,9,4,409,430,21
365,0,4,413,430,17
368,8,4,413,430,17
373,11,2,426,431,5
372,7,0,426,434,8
380,0,4,432,437,5
381,9,3,432,438,6
379,14,0,431,439,8
354,3,1,403,443,40
355,5,1,403,443,40
360,1,1,409,443,34
361,2,1,409,443,34
363,13,1,409,443,34
383,7,4,435,443,8
386,14,3,440,445,5
387,1,0,444,449,5
375,10,2,429,449,20
376,4,2,430,449,19
377,6,2,430,449,19
378,8,2,431,449,18
395,8,3,450,455,5
393,1,0,450,459,9
397,14,0,450,459,9
398,4,3,456,461,5
390,5,4,444,462,18
391,7,4,444,462,18
392,13,4,444,462,18
389,3,2,444,467,23
394,6,2,450,467,17
396,10,2,450,467,17
402,14,4,462,467,5
399,8,0,456,468,12
400,1,0,460,468,8
404,7,4,467,472,5
409,1,0,469,474,5
410,6,4,469,477,8
374,12,1,426,478,52
382,11,1,434,478,44
384,0,1,438,478,40
385,9,1,439,478,39
388,2,1,444,478,34
414,6,4,478,483,5
403,13,2,463,485,22
406,5,2,468,485,17
408,14,2,468,485,17
405,3,3,468,486,18
407,10,3,468,486,18
411,8,3,469,486,17
419,2,4,483,488,5
423,8,4,487,493,6
413,1,2,475,494,19
417,11,2,479,494,15
420,3,0,487,496,9
426,14,0,487,496,9
401,4,1,462,496,34
412,7,1,473,496,23
418,12,1,479,496,17
429,11,4,495,500,5
415,0,3,479,504,25
416,9,3,479,504,25
422,6,3,487,504,17
424,10,3,487,504,17
428,8,0,495,505,10
434,12,0,497,505,8
433,7,1,497,506,9
435,14,1,497,506,9
431,3,3,497,509,12
430,1,4,497,509,12
432,4,4,497,509,12
421,5,2,487,512,25
425,13,2,487,512,25
427,2,2,495,512,17
437,9,0,505,514,9
438,10,0,505,514,9
447,2,2,513,522,9
448,5,2,513,522,9
439,7,1,507,525,18
441,11,1,507,525,18
442,12,1,507,525,18
436,0,4,505,527,22
443,1,4,510,527,17
446,14,4,510,527,17
451,13,1,517,530,13
455,7,2,526,531,5
456,11,3,526,535,9
457,12,3,526,535,9
452,2,4,524,536,12
454,10,4,525,536,11
460,0,3,532,540,8
462,11,1,536,545,9
465,2,1,537,545,8
463,12,2,536,545,9
464,1,2,537,545,8
458,14,4,530,545,15
459,13,4,531,545,14
440,8,0,507,549,42
444,4,0,510,549,39
445,6,0,510,549,39
449,3,0,515,549,34
450,9,0,515,549,34
472,14,1,546,551,5
468,1,2,546,551,5
470,11,4,546,551,5
474,6,4,550,556,6
477,1,1,552,557,5
467,0,3,546,564,18
469,2,3,546,564,18
471,12,3,546,564,18
473,13,3,547,564,17
481,6,1,557,566,9
483,11,1,558,566,8
453,5,0,524,567,43
461,7,0,534,567,33
466,10,0,537,567,30
475,8,2,550,569,19
476,9,2,550,569,19
478,14,2,552,569,17
480,4,3,557,573,16
484,2,3,565,573,8
489,10,4,568,573,5
479,3,0,553,576,23
488,11,0,567,576,9
482,1,2,558,578,20
493,12,2,570,578,8
490,5,3,570,582,12
492,9,3,570,582,12
485,13,1,566,584,18
486,0,1,567,584,17
487,6,1,567,584,17
506,13,2,585,590,5
496,10,3,577,591,14
497,3,3,578,591,13
491,8,4,570,591,21
494,14,4,570,591,21
495,4,4,574,591,17
503,1,1,585,594,9
505,9,1,585,594,9
498,11,0,578,597,19
499,2,0,579,597,18
500,7,0,580,597,17
501,12,0,580,597,17
511,4,1,593,599,6
508,3,2,592,601,9
512,10,2,593,601,8
513,1,3,595,604,9
515,9,3,595,604,9
517,2,1,599,605,6
502,0,0,585,606,21
516,12,0,598,606,8
514,8,2,595,607,12
504,6,4,585,609,24
507,5,4,591,609,18
509,13,4,592,609,17
510,14,4,592,609,17
525,1,2,607,612,5
527,3,4,610,619,9
528,5,4,610,619,9
532,1,3,615,620,5
520,10,1,602,623,21
521,2,1,606,623,17
522,7,1,606,623,17
535,6,4,620,625,5
529,8,2,610,630,20
530,13,2,610,630,20
531,14,2,610,630,20
536,2,3,624,630,6
539,1,4,625,630,5
543,8,3,631,636,5
540,6,2,626,639,13
545,14,2,631,639,8
542,2,4,631,640,9
544,13,4,631,640,9
518,11,0,600,641,41
519,4,0,601,641,40
523,9,0,606,641,35
524,0,0,607,641,34
526,12,0,607,641,34
533,3,1,620,641,21
534,5,1,620,641,21
537,7,1,624,641,17
538,10,1,624,641,17
557,10,2,642,647,5
546,8,0,638,659,21
555,7,0,642,659,17
559,12,0,642,659,17
541,1,1,631,659,28
553,4,1,642,659,17
554,5,1,642,659,17
547,6,4,640,659,19
552,3,4,642,659,17
558,11,4,642,659,17
560,10,2,656,661,5
564,5,4,660,665,5
565,6,2,660,666,6
563,4,1,660,669,9
569,12,1,660,669,9
570,10,1,665,674,9
548,2,3,641,676,35
549,13,3,641,676,35
550,14,3,641,676,35
551,0,3,642,676,34
556,9,3,642,676,34
573,6,4,672,677,5
572,12,1,671,679,8
578,10,2,677,686,9
579,13,2,677,686,9
581,12,4,682,688,6
571,5,3,667,694,27
575,2,3,677,694,17
577,9,3,677,694,17
561,1,0,660,695,35
562,3,0,660,695,35
566,7,0,660,695,35
567,8,0,660,695,35
568,11,0,660,695,35
574,0,1,677,697,20
576,4,1,677,697,20
580,14,1,677,697,20
592,11,4,696,701,5
583,10,3,687,703,16
585,13,3,691,703,12
584,12,0,690,704,14
586,2,0,695,704,9
582,6,1,686,706,20
589,3,1,696,706,10
593,14,3,698,708,10
594,0,4,699,710,11
596,4,4,702,710,8
595,1,1,699,711,12
598,10,0,704,713,9
599,13,0,704,713,9
587,5,2,695,713,18
588,9,2,695,713,18
590,7,2,696,713,17
591,8,2,696,713,17
604,1,1,712,717,5
606,2,3,714,719,5
600,3,4,707,719,12
603,14,4,709,719,10
609,7,1,714,726,12
611,9,1,714,726,12
615,1,3,721,726,5
607,4,0,714,732,18
608,5,0,714,732,18
610,8,0,714,732,18
618,1,4,727,732,5
619,7,3,727,733,6
614,14,0,720,741,21
621,1,0,733,741,8
625,7,3,736,741,5
616,2,1,722,744,22
617,3,1,722,744,22
620,9,1,727,744,17
597,11,2,702,748,46
601,6,2,707,748,41
602,12,2,707,748,41
605,0,2,714,748,34
612,10,2,714,748,34
613,13,2,714,748,34
628,9,1,745,750,5
626,1,0,742,751,9
627,14,0,742,751,9
629,7,3,746,751,5
622,4,4,733,751,18
623,5,4,733,751,18
624,8,4,733,751,18
639,4,3,752,757,5
642,8,2,752,761,9
643,9,2,752,761,9
645,4,3,760,765,5
634,10,0,749,769,20
635,11,0,749,769,20
641,7,0,752,769,17
644,14,0,752,769,17
636,12,4,749,769,20
638,1,4,752,769,17
640,5,4,752,769,17
647,9,3,764,770,6
652,10,4,770,775,5
649,1,2,770,779,9
650,5,2,770,779,9
653,11,3,770,779,9
654,12,3,770,779,9
656,9,4,775,784,9
657,10,4,776,784,8
630,0,1,749,785,36
631,2,1,749,785,36
632,3,1,749,785,36
633,6,1,749,785,36
637,13,1,749,785,36
648,4,0,766,787,21
651,7,0,770,787,17
655,14,0,770,787,17
659,5,2,780,789,9
660,11,2,780,789,9
662,9,4,785,794,9
665,2,4,786,794,8
670,7,2,792,797,5
668,3,3,789,798,9
669,14,3,789,798,9
671,5,4,793,799,6
646,8,1,764,803,39
663,10,1,785,803,18
664,0,1,786,803,17
677,14,4,799,804,5
658,1,0,780,805,25
661,12,0,780,805,25
666,13,0,786,805,19
667,6,0,787,805,18
680,7,4,804,809,5
685,12,1,806,811,5
688,13,4,810,815,5
687,7,1,810,816,6
672,4,3,795,816,21
673,9,3,795,816,21
674,11,3,796,816,20
676,3,3,799,816,17
684,6,3,806,821,15
678,5,2,803,822,19
681,8,2,804,822,18
682,10,2,804,822,18
675,2,0,797,823,26
679,0,0,804,823,19
683,1,0,806,823,17
686,14,0,806,823,17
690,3,4,817,826,9
694,11,4,817,826,9
696,6,3,822,827,5
702,0,4,825,831,6
692,7,0,817,832,15
701,2,0,824,832,8
689,12,1,815,834,19
691,4,1,817,834,17
693,9,1,817,834,17
695,13,1,817,834,17
703,3,3,827,836,9
704,14,3,828,836,8
705,6,4,829,836,7
697,5,2,823,841,18
698,8,2,823,841,18
699,10,2,823,841,18
700,1,2,824,841,17
712,12,3,835,841,6
714,3,4,837,846,9
715,14,4,837,846,9
717,5,2,842,847,5
706,11,0,831,850,19
707,0,0,832,850,18
708,7,0,833,850,17
719,8,3,842,851,9
720,10,3,842,851,9
709,2,1,834,852,18
710,4,1,835,852,17
711,9,1,835,852,17
713,13,1,835,852,17
716,1,4,842,855,13
718,6,4,842,855,13
727,11,1,851,857,6
725,0,2,851,860,9
728,8,2,852,860,8
722,3,4,848,860,12
721,12,0,842,868,26
723,5,0,850,868,18
726,7,0,851,868,17
732,1,2,856,869,13
733,9,2,856,869,13
734,4,4,860,869,9
737,11,4,861,869,8
735,6,1,860,870,10
736,3,1,861,870,9
724,14,3,850,870,20
729,10,3,852,870,18
730,2,3,853,870,17
731,13,3,853,870,17
741,7,0,869,874,5
742,12,4,869,874,5
738,8,2,867,878,11
739,0,2,869,878,9
749,10,0,871,879,8
743,1,3,870,879,9
744,4,3,870,879,9
746,3,4,871,883,12
750,13,4,871,883,12
745,2,2,871,887,16
748,9,2,871,887,16
740,5,1,869,888,19
747,6,1,871,888,17
751,14,1,871,888,17
760,3,4,884,889,5
761,13,2,884,892,8
765,2,1,890,895,5
752,7,0,876,897,21
753,0,0,879,897,18
755,4,0,880,897,17
757,10,0,880,897,17
754,1,3,880,898,18
756,8,3,880,898,18
758,11,3,880,898,18
759,12,3,880,898,18
763,6,4,889,898,9
766,3,4,890,898,8
767,2,1,896,901,5
773,14,4,898,903,5
775,8,2,899,904,5
769,4,3,898,907,9
776,12,3,899,907,8
777,2,2,902,913,11
778,11,2,903,913,10
780,6,1,905,914,9
781,8,1,905,914,9
779,3,3,904,916,12
783,12,3,908,916,8
782,4,4,908,917,9
784,14,4,908,917,9
789,3,1,917,922,5
787,2,3,916,925,9
790,12,3,917,925,8
792,4,2,923,929,6
794,12,1,926,931,5
762,5,0,889,933,44
764,9,0,889,933,44
768,0,0,898,933,35
770,7,0,898,933,35
771,10,0,898,933,35
772,13,0,898,933,35
774,1,0,899,933,34
795,2,3,928,933,5
785,11,4,914,935,21
786,8,4,915,935,20
788,6,4,916,935,19
796,4,1,930,936,6
797,12,2,932,937,5
803,13,4,934,940,6
805,8,2,936,942,6
799,5,1,934,945,11
804,6,1,936,945,9
808,12,4,939,945,6
807,2,2,939,947,8
791,14,0,918,951,33
793,3,0,926,951,25
802,10,0,934,951,17
812,5,4,946,951,5
798,0,3,934,952,18
800,7,3,934,952,18
801,9,3,934,952,18
809,4,1,941,954,13
810,13,1,943,954,11
823,13,4,955,960,5
818,5,3,952,961,9
819,10,3,952,961,9
811,1,2,946,965,19
814,8,2,946,965,19
815,12,2,946,965,19
824,4,4,961,966,5
806,11,0,936,969,33
813,6,0,946,969,23
820,14,0,952,969,17
826,5,2,962,970,8
825,13,3,961,970,9
827,7,3,962,970,8
816,2,1,952,972,20
817,3,1,952,972,20
822,9,1,955,972,17
840,13,4,973,979,6
841,2,3,983,989,6
835,7,2,972,990,18
836,14,2,972,990,18
837,3,2,973,990,17
843,13,3,990,995,5
842,2,4,990,995,5
