task_id,user_id,server_id,generation_time,completion_time,latency
9,9,2,0,10,10
14,14,2,0,10,10
15,9,2,11,16,5
16,14,2,14,25,11
17,9,2,17,25,8
0,0,0,0,35,35
1,1,0,0,35,35
2,2,0,0,35,35
6,6,0,0,35,35
8,8,0,0,35,35
11,11,0,0,35,35
13,13,0,0,35,35
18,9,1,26,35,9
19,14,1,26,35,9
3,3,3,0,35,35
4,4,3,0,35,35
5,5,3,0,35,35
7,7,3,0,35,35
10,10,3,0,35,35
12,12,3,0,35,35
34,14,0,36,41,5
21,1,1,36,54,18
25,5,1,36,54,18
30,10,1,36,54,18
32,12,1,36,54,18
26,6,2,36,54,18
28,8,2,36,54,18
29,9,2,36,54,18
33,13,2,36,54,18
20,0,3,36,54,18
22,2,3,36,54,18
31,11,3,36,54,18
23,3,4,36,54,18
24,4,4,36,54,18
27,7,4,36,54,18
37,1,1,55,64,9
44,8,1,55,64,9
39,3,2,55,64,9
45,9,2,55,64,9
35,14,4,48,72,24
43,7,4,55,72,17
46,10,4,55,72,17
48,12,4,55,72,17
36,0,0,55,73,18
41,5,0,55,73,18
42,6,0,55,73,18
38,2,3,55,73,18
40,4,3,55,73,18
47,11,3,55,73,18
49,13,3,55,73,18
50,1,1,65,74,9
52,8,1,65,74,9
53,9,4,65,77,12
51,3,0,65,82,17
63,11,0,74,82,8
59,2,4,74,82,8
57,14,1,73,83,10
58,0,1,74,83,9
55,10,3,73,83,10
61,5,3,74,83,9
71,0,0,84,89,5
65,1,4,82,93,11
73,10,4,84,93,9
67,2,1,83,101,18
69,9,1,83,101,18
70,11,1,83,101,18
66,8,3,82,101,19
68,3,3,83,101,18
72,5,3,84,101,17
74,14,3,84,101,17
75,10,4,94,103,9
76,0,4,95,103,8
54,7,2,73,108,35
56,12,2,73,108,35
60,4,2,74,108,34
62,6,2,74,108,34
64,13,2,74,108,34
85,0,4,104,109,5
86,10,0,105,110,5
78,2,3,102,111,9
83,11,3,102,111,9
82,9,2,102,117,15
89,7,2,109,117,8
88,6,4,109,118,9
90,12,4,109,118,9
87,4,0,109,119,10
91,0,0,110,119,9
94,11,3,115,120,5
98,12,2,119,124,5
92,10,4,113,127,14
97,6,4,119,127,8
93,2,0,115,128,13
100,4,0,120,128,8
95,7,3,118,129,11
96,9,3,118,129,11
101,12,2,125,134,9
102,11,2,126,134,8
105,2,3,129,134,5
99,0,4,120,134,14
77,1,1,95,136,41
79,3,1,102,136,34
80,5,1,102,136,34
81,8,1,102,136,34
84,14,1,102,136,34
111,11,3,135,140,5
109,0,4,135,141,6
110,2,1,135,145,10
112,12,1,135,145,10
106,4,0,129,147,18
107,7,0,130,147,17
108,9,0,130,147,17
115,0,3,142,148,6
117,3,1,145,150,5
114,11,0,141,152,11
103,6,2,128,152,24
104,10,2,128,152,24
113,13,2,135,152,17
119,5,4,146,155,9
120,8,4,146,155,9
126,7,1,151,157,6
121,12,3,146,157,11
122,4,3,148,157,9
124,0,0,149,161,12
125,3,0,151,161,10
127,1,4,153,164,11
132,8,4,156,164,8
128,6,3,153,166,13
131,13,3,153,166,13
133,5,1,160,170,10
137,4,1,162,170,8
139,1,0,165,171,6
138,12,4,162,173,11
140,8,4,165,173,8
142,1,1,172,178,6
144,5,0,173,182,9
145,6,0,173,182,9
134,7,3,161,184,23
135,0,3,162,184,22
141,13,3,167,184,17
148,1,1,181,186,5
116,14,2,144,187,43
118,2,2,146,187,41
123,9,2,148,187,39
129,10,2,153,187,34
130,11,2,153,187,34
151,0,1,185,191,6
143,4,4,172,191,19
146,8,4,174,191,17
147,12,4,174,191,17
154,1,0,187,192,5
149,5,3,183,193,10
150,6,3,183,193,10
157,4,4,192,197,5
163,14,0,193,199,6
156,2,3,192,202,10
161,1,3,193,202,9
166,6,0,200,205,5
136,3,2,162,205,43
152,7,2,185,205,20
153,13,2,185,205,20
169,2,0,203,210,7
155,0,1,192,210,18
158,8,1,192,210,18
162,9,1,193,210,17
165,5,3,200,211,11
168,1,3,203,211,8
173,13,4,206,211,5
176,8,0,211,216,5
175,2,1,211,220,9
177,9,1,211,220,9
181,8,0,217,222,5
182,2,4,221,226,5
184,8,0,223,228,5
174,0,3,211,229,18
178,1,3,212,229,17
179,5,3,212,229,17
180,13,3,212,229,17
188,1,0,230,235,5
189,5,1,230,235,5
186,8,4,229,238,9
190,13,4,230,238,8
185,2,3,227,239,12
187,0,3,230,239,9
159,10,2,192,240,48
160,12,2,192,240,48
164,4,2,198,240,42
167,14,2,200,240,40
170,3,2,206,240,34
171,6,2,206,240,34
172,7,2,206,240,34
192,5,0,236,241,5
191,1,1,236,241,5
203,1,0,242,247,5
193,8,1,239,248,9
194,13,4,239,248,9
195,0,4,240,248,8
204,1,0,248,253,5
207,8,1,249,258,9
208,13,1,249,258,9
183,9,2,221,258,37
196,2,2,240,258,18
197,3,2,241,258,17
202,14,2,241,258,17
199,7,3,241,259,18
200,10,3,241,259,18
201,12,3,241,259,18
198,6,4,241,266,25
205,5,4,248,266,18
206,0,4,249,266,17
209,1,2,255,267,12
214,9,2,259,267,8
210,2,3,259,268,9
219,12,3,260,268,8
215,13,4,259,276,17
221,1,4,268,276,8
211,3,1,259,277,18
212,4,1,259,277,18
216,14,1,259,277,18
220,0,3,267,277,10
222,5,3,268,277,9
213,8,0,259,278,19
217,7,0,260,278,18
218,10,0,260,278,18
225,2,2,273,282,9
226,12,2,273,282,9
224,6,4,269,285,16
228,13,4,277,285,8
227,1,2,277,287,10
235,8,3,279,288,9
236,10,3,279,288,9
238,13,2,286,294,8
231,4,0,278,296,18
233,14,0,278,296,18
234,7,0,279,296,17
223,9,1,268,296,28
229,0,1,278,296,18
230,3,1,278,296,18
232,5,1,278,296,18
244,13,2,295,300,5
246,3,0,297,302,5
239,2,3,287,306,19
242,8,3,289,306,17
243,10,3,289,306,17
248,5,4,297,306,9
249,7,4,297,306,9
250,9,2,297,309,12
251,14,2,297,309,12
259,9,3,310,315,5
260,14,4,310,315,5
256,7,0,307,316,9
257,8,0,307,316,9
262,8,0,317,322,5
261,7,3,317,322,5
263,14,4,318,324,6
264,9,3,321,327,6
237,6,1,286,331,45
240,12,1,287,331,44
241,1,1,288,331,43
245,0,1,297,331,34
247,4,1,297,331,34
265,7,0,323,332,9
266,8,0,323,332,9
273,1,4,333,338,5
267,14,0,327,341,14
272,12,0,332,341,9
269,0,3,332,342,10
270,4,3,332,342,10
252,3,2,303,344,41
253,13,2,304,344,40
254,2,2,307,344,37
255,5,2,307,344,37
258,10,2,307,344,37
276,1,4,339,345,6
277,12,3,342,347,5
268,9,2,328,349,21
271,6,1,332,350,18
274,7,1,333,350,17
275,8,1,333,350,17
286,1,3,346,353,7
287,12,0,348,354,6
291,8,0,351,359,8
278,14,4,342,363,21
280,4,4,343,363,20
281,2,4,345,363,18
284,10,4,345,363,18
292,1,3,354,364,10
293,12,3,355,364,9
279,0,1,343,368,25
282,3,1,345,368,23
283,5,1,345,368,23
285,13,1,345,368,23
288,9,2,350,368,18
289,6,2,351,368,17
290,7,2,351,368,17
300,12,4,365,370,5
297,10,0,364,373,9
298,14,0,364,373,9
294,8,3,362,374,12
295,2,3,364,374,10
308,12,4,371,376,5
296,4,2,364,377,13
299,1,2,365,377,12
303,5,0,369,378,9
309,10,2,374,382,8
311,2,0,375,383,8
312,8,4,375,385,10
313,12,4,377,385,8
301,0,1,369,387,18
302,3,1,369,387,18
307,13,1,369,387,18
315,1,1,383,392,9
304,6,3,369,392,23
305,7,3,369,392,23
306,9,3,369,392,23
310,14,3,374,392,18
324,1,2,393,400,7
314,5,0,382,401,19
317,10,0,383,401,18
318,2,0,384,401,17
325,6,1,393,402,9
327,9,1,393,402,9
319,8,4,386,405,19
321,0,4,388,405,17
322,3,4,388,405,17
329,1,1,401,407,6
332,2,0,403,408,5
333,6,4,403,411,8
338,8,0,410,416,6
330,5,2,402,421,19
331,10,2,402,421,19
334,9,2,403,421,18
341,8,0,417,422,5
339,6,2,416,426,10
335,3,1,409,427,18
336,0,1,410,427,17
337,2,1,410,427,17
316,4,3,383,427,44
320,12,3,386,427,41
323,13,3,388,427,39
326,7,3,393,427,34
328,14,3,393,427,34
344,10,4,422,427,5
345,8,0,423,428,5
351,7,0,428,433,5
346,6,2,427,436,9
352,10,2,428,436,8
340,1,1,417,445,28
342,5,1,422,445,23
343,9,1,422,445,23
356,8,2,429,445,16
357,6,2,437,445,8
358,7,0,441,446,5
349,3,3,428,446,18
353,12,3,428,446,18
354,13,3,428,446,18
355,14,3,428,446,18
347,0,4,428,446,18
348,2,4,428,446,18
350,4,4,428,446,18
362,6,2,446,451,5
363,8,3,446,455,9
372,14,3,447,455,8
360,1,0,446,464,18
365,0,0,447,464,17
371,13,0,447,464,17
364,9,1,446,464,18
366,2,1,447,464,17
369,7,1,447,464,17
379,7,0,465,470,5
380,9,3,465,470,5
382,7,3,471,480,9
383,9,3,471,480,9
359,10,4,441,482,41
361,5,4,446,482,36
367,3,4,447,482,35
368,4,4,447,482,35
370,12,4,447,482,35
384,7,2,481,491,10
389,12,2,483,491,8
385,9,3,481,492,11
386,4,3,483,492,9
387,5,4,483,492,9
388,10,4,483,492,9
390,3,4,491,497,6
394,5,0,493,498,5
393,4,3,493,498,5
373,8,1,457,499,42
374,14,1,457,499,42
375,6,1,461,499,38
376,0,1,465,499,34
377,1,1,465,499,34
378,2,1,465,499,34
381,13,1,465,499,34
397,3,3,498,503,5
391,7,2,492,510,18
392,12,2,492,510,18
395,9,2,493,510,17
400,0,3,500,512,12
402,6,3,504,512,8
403,8,0,504,513,9
404,3,0,505,513,8
396,10,1,493,517,24
399,5,1,499,517,18
401,1,1,500,517,17
398,4,2,499,519,20
407,9,2,511,519,8
405,2,4,511,520,9
408,12,4,511,520,9
409,6,3,513,522,9
410,0,3,514,522,8
406,7,0,511,523,12
411,3,0,514,523,9
414,5,1,518,523,5
412,8,4,514,525,11
415,10,2,518,528,10
416,4,2,520,528,8
422,3,4,524,531,7
417,9,0,520,532,12
418,2,0,521,532,11
423,5,1,524,533,9
424,7,1,524,533,9
425,8,0,526,537,11
426,4,2,529,538,9
427,10,2,529,538,9
413,1,3,518,540,22
419,12,3,521,540,19
420,0,3,523,540,17
421,6,3,523,540,17
432,7,0,534,542,8
428,3,2,532,543,11
437,0,0,542,547,5
433,8,1,538,547,9
434,10,1,539,547,8
439,12,2,542,549,7
429,2,4,533,551,18
430,9,4,533,551,18
431,5,4,534,551,17
444,10,2,548,554,6
445,12,4,550,557,7
435,4,3,541,559,18
436,6,3,541,559,18
438,1,3,542,559,17
449,10,1,555,560,5
447,5,2,552,560,8
450,12,4,558,563,5
440,3,0,544,565,21
441,7,0,545,565,20
443,8,0,548,565,17
442,0,3,548,565,17
452,4,2,560,569,9
455,10,2,561,569,8
454,6,1,561,571,10
456,14,1,561,571,10
451,1,4,560,572,12
453,5,4,561,572,11
458,0,3,566,575,9
461,8,3,566,575,9
460,7,1,566,576,10
459,3,2,566,578,12
463,10,2,570,578,8
466,1,4,575,580,5
446,2,0,552,583,31
448,9,0,552,583,31
457,12,0,564,583,19
471,3,1,579,584,5
467,14,3,575,584,9
468,0,3,576,584,8
473,1,1,582,589,7
475,9,4,584,589,5
470,7,3,577,593,16
476,12,3,584,593,9
479,14,1,588,594,6
480,1,4,590,595,5
464,6,2,572,596,24
469,8,2,576,596,20
472,10,2,579,596,17
483,12,3,595,600,5
462,4,0,570,601,31
465,5,0,573,601,28
474,2,0,584,601,17
482,7,4,594,604,10
484,14,4,595,604,9
477,0,2,585,605,20
481,9,2,590,605,15
486,6,3,597,605,8
487,8,1,597,606,9
488,10,1,597,606,9
496,6,1,606,611,5
490,2,3,602,614,12
492,5,3,602,614,12
498,10,1,613,618,5
478,3,0,585,619,34
485,1,0,596,619,23
491,4,0,602,619,17
499,8,4,614,619,5
500,5,3,616,625,9
501,2,3,617,625,8
502,6,1,617,627,10
503,10,1,619,627,8
508,5,0,626,631,5
510,10,0,631,636,5
507,2,1,626,636,10
509,6,1,628,636,8
504,1,4,620,638,18
505,4,4,620,638,18
506,8,4,620,638,18
489,12,2,601,640,39
493,7,2,605,640,35
494,14,2,605,640,35
495,0,2,606,640,34
497,9,2,606,640,34
515,10,0,637,642,5
513,3,1,637,642,5
518,8,4,639,644,5
512,2,3,637,647,10
517,4,3,639,647,8
521,3,0,643,648,5
522,10,1,643,648,5
524,4,1,648,653,5
519,9,4,641,653,12
520,0,4,643,653,10
523,2,0,648,654,6
525,8,3,648,657,9
526,3,3,649,657,8
511,5,2,632,658,26
514,6,2,637,658,21
516,1,2,639,658,19
530,9,1,654,659,5
527,10,4,649,662,13
531,12,4,654,662,8
539,6,0,659,664,5
534,7,1,658,668,10
537,1,1,659,668,9
540,12,0,664,673,9
541,10,0,665,673,8
529,4,3,654,675,21
533,3,3,658,675,17
536,14,3,658,675,17
528,0,2,654,676,22
532,2,2,655,676,21
535,8,2,658,676,18
545,7,0,671,679,8
546,10,1,674,683,9
547,12,1,675,683,8
550,0,2,678,683,5
538,5,3,659,684,25
549,4,3,676,684,8
553,7,0,680,685,5
542,6,4,668,686,18
543,9,4,668,686,18
544,1,4,669,686,17
555,0,0,684,694,10
557,12,0,684,694,10
558,4,2,685,694,9
560,7,2,686,694,8
552,8,3,679,695,16
559,5,3,685,695,10
562,6,2,691,699,8
548,3,1,676,701,25
551,2,1,679,701,22
554,14,1,681,701,20
556,10,1,684,701,17
563,9,3,693,704,11
568,5,3,696,704,8
575,5,2,705,710,5
573,14,1,703,712,9
574,3,1,704,712,8
561,1,0,691,713,22
565,4,0,695,713,18
569,8,0,696,713,17
564,0,4,695,713,18
566,7,4,695,713,18
567,12,4,695,713,18
577,5,2,711,716,5
583,8,1,714,719,5
584,12,2,714,721,7
571,2,3,702,722,20
572,10,3,703,722,19
576,9,3,705,722,17
570,6,0,701,723,22
580,0,0,714,723,9
588,12,1,722,727,5
585,5,0,717,728,11
586,8,2,720,730,10
587,1,2,721,730,9
578,3,4,713,731,18
579,14,4,713,731,18
581,4,4,714,731,17
592,0,1,727,732,5
594,12,0,728,733,5
600,4,1,734,739,5
595,5,2,729,739,10
597,8,2,731,739,8
582,7,3,714,740,26
590,9,3,723,740,17
591,10,3,723,740,17
589,2,4,723,740,17
596,1,4,731,740,9
599,0,0,734,743,9
602,3,0,735,743,8
606,1,4,741,746,5
601,12,2,734,748,14
605,8,2,740,748,8
604,5,1,740,749,9
607,2,1,741,749,8
613,3,0,747,752,5
611,7,1,746,755,9
610,0,4,746,756,10
612,1,4,747,756,9
615,2,2,750,759,9
616,5,2,750,759,9
617,12,0,750,761,11
618,3,0,753,761,8
619,7,1,756,761,5
614,8,4,749,765,16
620,0,4,757,765,8
621,1,2,757,769,12
622,2,2,760,769,9
629,1,0,770,775,5
593,6,3,728,775,47
598,14,3,732,775,43
603,4,3,740,775,35
608,9,3,741,775,34
609,10,3,741,775,34
627,0,4,766,775,9
628,8,4,766,775,9
623,5,1,761,780,19
624,3,1,762,780,18
625,7,1,762,780,18
626,12,1,762,780,18
635,8,0,776,781,5
636,9,4,776,781,5
632,1,3,776,785,9
637,10,3,776,785,9
640,7,0,781,786,5
630,2,1,770,789,19
638,14,1,776,789,13
639,5,4,781,790,9
642,8,4,782,790,8
644,1,0,786,791,5
631,0,2,776,794,18
633,4,2,776,794,18
634,6,2,776,794,18
641,12,3,781,794,13
643,9,3,782,794,12
652,1,1,792,797,5
650,5,0,791,800,9
651,8,0,791,800,9
655,9,2,795,804,9
656,12,2,795,804,9
659,5,1,803,808,5
645,7,4,787,808,21
647,3,4,789,808,19
648,2,4,790,808,18
657,1,0,799,809,10
658,8,0,801,809,8
646,10,3,787,812,25
649,14,3,790,812,22
654,4,3,795,812,17
665,5,2,809,814,5
661,9,0,805,818,13
668,8,0,810,818,8
663,2,1,809,818,9
667,1,1,810,818,8
653,0,4,795,826,31
660,6,4,804,826,22
666,7,4,809,826,17
670,5,2,818,827,9
673,8,2,819,827,8
672,2,0,819,828,9
675,14,0,819,828,9
671,1,1,819,829,10
674,9,1,819,829,10
662,12,3,805,831,26
664,3,3,809,831,22
669,4,3,814,831,17
679,10,4,827,836,9
680,5,4,828,836,8
685,9,0,830,837,7
677,6,1,827,838,11
684,1,1,830,838,8
682,2,2,829,838,9
683,14,2,829,838,9
676,0,3,827,849,22
678,7,3,827,849,22
681,8,3,828,849,21
694,2,2,845,854,9
695,1,2,846,854,8
690,10,3,837,854,17
686,3,4,832,854,22
687,12,4,832,854,22
688,4,4,837,854,17
689,5,1,837,856,19
691,9,1,838,856,18
692,6,1,839,856,17
693,14,1,839,856,17
699,1,1,855,861,6
696,0,2,850,863,13
697,7,2,850,863,13
698,8,3,852,863,11
703,10,3,855,863,8
708,5,1,860,866,6
711,7,1,864,871,7
700,2,4,855,873,18
701,3,4,855,873,18
702,4,4,855,873,18
704,12,4,855,873,18
714,5,1,869,876,7
715,7,0,872,879,7
705,14,2,857,881,24
709,1,2,862,881,19
710,0,2,864,881,17
706,6,3,859,881,22
707,9,3,859,881,22
713,10,3,864,881,17
720,3,1,879,885,6
722,0,0,882,887,5
726,10,1,882,890,8
724,6,2,882,891,9
725,9,2,882,891,9
712,8,4,864,891,27
716,2,4,874,891,17
717,4,4,874,891,17
729,0,0,889,894,5
728,14,1,888,895,7
732,4,0,892,899,7
718,12,3,874,899,25
721,7,3,880,899,19
723,1,3,882,899,17
727,3,2,887,900,13
734,8,2,892,900,8
731,2,1,892,904,12
733,6,1,892,904,12
740,7,0,900,905,5
719,5,4,878,909,31
730,10,4,891,909,18
735,9,4,892,909,17
744,7,0,906,911,5
746,6,1,907,913,6
749,7,1,913,918,5
736,0,2,897,918,21
737,14,2,899,918,19
738,1,2,900,918,18
739,4,3,900,918,18
741,12,3,900,918,18
742,3,3,901,918,17
743,8,4,901,918,17
745,2,4,907,918,11
750,6,3,914,923,9
754,2,4,919,928,9
760,14,4,919,928,9
751,5,1,918,936,18
752,0,1,919,936,17
755,3,1,919,936,17
747,9,2,910,936,26
748,10,2,910,936,26
756,4,2,919,936,17
753,1,0,919,937,18
757,7,0,919,937,18
758,8,0,919,937,18
759,12,0,919,937,18
761,6,4,928,938,10
763,2,4,930,938,8
774,2,0,939,944,5
767,5,4,937,947,10
775,6,4,939,947,8
776,2,0,948,953,5
762,14,1,929,954,25
764,0,1,937,954,17
765,3,1,937,954,17
766,4,2,937,955,18
769,10,2,937,955,18
772,8,2,938,955,17
773,12,2,938,955,17
768,9,3,937,956,19
770,1,3,938,956,18
771,7,3,938,956,18
777,5,4,948,957,9
778,6,4,948,957,9
785,10,4,956,962,6
779,2,0,954,963,9
782,14,0,955,963,8
783,4,2,956,963,7
790,5,2,963,968,5
795,14,4,964,969,5
780,0,1,955,973,18
784,8,1,956,973,17
786,12,1,956,973,17
781,3,3,955,974,19
787,1,3,957,974,17
788,7,3,957,974,17
789,9,3,957,974,17
797,14,2,970,975,5
796,5,4,970,975,5
799,8,3,974,979,5
800,12,2,974,980,6
791,6,0,963,982,19
793,2,0,964,982,18
794,4,0,964,982,18
792,10,1,963,982,19
798,0,1,974,982,8
806,5,3,979,988,9
807,8,3,980,988,8
808,12,0,981,991,10
812,6,0,983,991,8
809,0,2,983,992,9
811,4,2,983,992,9
803,9,4,975,993,18
804,3,4,976,993,17
805,14,4,976,993,17
815,8,3,989,994,5
