task_id,user_id,server_id,generation_time,completion_time,latency
0,0,1,0,10,10
1,1,1,0,10,10
10,0,4,12,17,5
2,2,3,0,18,18
5,5,3,0,18,18
8,9,3,0,18,18
11,1,3,12,24,12
15,9,4,19,25,6
12,0,2,18,29,11
14,5,2,19,29,10
16,1,1,25,31,6
17,9,4,26,31,5
3,3,0,0,35,35
4,4,0,0,35,35
6,7,0,0,35,35
7,8,0,0,35,35
9,6,0,1,35,34
20,1,4,32,37,5
18,0,3,30,41,11
21,9,3,32,41,9
23,4,4,36,43,7
13,2,0,19,44,25
19,5,0,30,44,14
27,6,2,38,44,6
30,4,1,44,53,9
33,6,1,45,53,8
29,9,4,43,53,10
31,2,4,45,53,8
28,0,0,42,54,12
32,5,0,45,54,9
22,3,3,36,59,23
24,7,3,36,59,23
25,8,3,36,59,23
26,1,3,38,59,21
34,4,4,54,59,5
44,8,4,61,66,5
37,2,0,55,67,12
39,9,0,55,67,12
42,4,2,60,70,10
43,7,2,61,70,9
35,6,1,54,72,18
36,0,1,55,72,17
38,5,1,55,72,17
46,2,4,68,74,6
50,0,2,73,78,5
51,5,4,73,79,6
48,4,1,71,81,10
49,7,1,71,81,10
52,6,3,73,84,11
53,2,3,76,84,8
40,1,0,60,85,25
41,3,0,60,85,25
45,8,0,67,85,18
47,9,0,68,85,17
55,0,4,82,87,5
61,3,0,86,91,5
54,5,1,81,92,11
56,4,1,82,92,10
57,7,2,82,94,12
60,1,2,86,94,8
65,3,3,92,98,6
67,4,2,94,100,6
62,8,1,86,103,17
66,5,1,93,103,10
68,7,3,95,104,9
58,2,4,85,105,20
59,6,4,85,105,20
63,9,4,86,105,19
64,0,4,88,105,17
74,7,2,105,110,5
78,9,1,106,111,5
71,4,0,101,115,14
76,2,0,106,115,9
82,2,0,118,123,5
72,5,3,104,123,19
73,8,3,104,123,19
75,0,3,106,123,17
69,1,4,96,123,27
70,3,4,99,123,24
77,6,4,106,123,17
79,9,1,113,124,11
80,7,1,114,124,10
90,7,1,125,130,5
87,6,2,124,130,6
81,4,4,116,132,16
86,5,4,124,132,8
85,3,3,124,133,9
88,8,3,124,133,9
95,5,3,133,138,5
97,8,2,134,139,5
83,0,0,124,143,19
84,1,0,124,143,19
89,2,0,125,143,18
91,9,0,125,143,18
99,8,4,140,145,5
102,2,2,144,149,5
101,1,3,144,149,5
92,6,1,131,150,19
93,7,1,131,150,19
94,4,1,133,150,17
105,1,2,150,155,5
108,6,3,151,160,9
109,7,3,151,160,9
96,3,0,134,162,28
98,5,0,139,162,23
100,0,0,144,162,18
103,9,0,144,162,18
112,7,3,161,166,5
104,8,1,149,168,19
106,2,1,150,168,18
107,4,1,151,168,17
111,6,2,161,169,8
118,2,2,169,174,5
121,6,4,170,175,5
122,2,2,175,180,5
110,1,0,157,181,24
113,0,0,163,181,18
114,3,0,163,181,18
115,5,1,163,186,23
116,9,1,163,186,23
117,7,1,167,186,19
119,4,1,169,186,17
120,8,0,169,188,19
129,5,0,187,194,7
123,6,1,176,196,20
130,7,1,187,196,9
128,4,4,187,196,9
131,9,4,187,196,9
124,2,3,181,199,18
125,0,3,182,199,17
126,1,3,182,199,17
127,3,3,182,199,17
134,4,4,197,203,6
138,0,0,200,207,7
132,8,1,194,207,13
135,6,1,197,207,10
144,6,2,208,213,5
139,1,1,200,225,25
142,4,1,204,225,21
143,0,1,208,225,17
149,4,0,226,231,5
147,0,4,226,233,7
133,5,3,196,234,38
136,7,3,197,234,37
137,9,3,197,234,37
140,2,3,200,234,34
141,3,3,200,234,34
150,4,0,232,238,6
155,7,4,235,240,5
151,0,1,234,241,7
152,2,0,235,247,12
156,9,0,235,247,12
159,0,2,242,248,6
157,4,1,239,251,12
158,7,1,241,251,10
160,2,0,248,255,7
162,9,2,249,255,6
161,0,4,249,255,6
163,7,1,255,261,6
164,0,2,256,261,5
167,9,4,256,262,6
165,2,0,256,264,8
168,7,1,262,267,5
170,9,2,263,268,5
169,0,0,263,269,6
145,8,3,208,270,62
146,6,3,214,270,56
148,1,3,226,270,44
153,3,3,235,270,35
154,5,3,235,270,35
171,2,2,265,273,8
174,0,4,270,275,5
166,4,3,256,276,20
172,7,0,268,278,10
173,9,0,269,278,9
175,1,1,271,279,8
178,6,2,271,282,11
179,8,2,272,282,10
181,0,4,277,282,5
180,2,3,274,286,12
182,4,3,277,286,9
185,9,4,280,287,7
176,3,0,271,288,17
177,5,0,271,288,17
187,8,1,283,290,7
184,7,2,280,291,11
186,6,2,283,291,8
183,1,3,280,291,11
192,3,0,289,294,5
190,4,4,287,297,10
191,9,4,288,297,9
194,8,3,291,300,9
196,6,3,292,300,8
195,1,0,292,301,9
200,4,4,299,304,5
198,7,1,296,307,11
199,9,1,298,307,9
197,3,3,296,307,11
188,0,2,284,309,25
189,2,2,287,309,22
193,5,2,289,309,20
204,4,0,305,311,6
201,6,4,301,313,12
202,8,4,301,313,12
209,2,1,310,315,5
206,9,3,308,315,7
207,3,0,309,321,12
208,0,0,310,321,11
211,4,1,312,321,9
203,1,2,302,321,19
205,7,2,308,321,13
210,5,4,310,324,14
214,2,4,316,324,8
212,6,3,315,325,10
215,9,3,316,325,9
216,0,4,322,329,7
213,8,2,315,330,15
219,4,2,322,330,8
223,6,0,326,331,5
217,1,1,322,333,11
218,3,1,322,333,11
228,6,4,333,338,5
222,5,2,325,339,14
226,4,2,331,339,8
225,0,0,330,341,11
227,8,0,331,341,10
220,7,3,323,343,20
221,2,3,325,343,18
224,9,3,326,343,17
230,3,4,337,343,6
229,1,2,334,349,15
231,6,2,339,349,10
232,4,3,340,352,12
235,8,3,342,352,10
233,5,4,341,352,11
237,3,4,344,352,8
236,2,0,344,353,9
240,1,1,350,359,9
241,6,1,350,359,9
234,0,2,342,359,17
238,7,2,344,359,15
244,2,4,354,360,6
239,9,3,345,361,16
242,4,3,353,361,8
243,8,0,353,362,9
245,5,0,354,362,8
248,1,4,360,369,9
250,2,4,361,369,8
246,3,0,358,371,13
257,2,0,370,376,6
255,8,4,363,379,16
256,1,4,370,379,9
251,6,1,361,380,19
252,4,1,362,380,18
254,5,1,363,380,17
247,0,3,360,380,20
249,7,3,360,380,20
253,9,3,362,380,18
258,3,2,376,382,6
259,2,0,378,384,6
262,0,4,381,392,11
267,9,4,381,392,11
260,1,2,380,400,20
263,4,2,381,400,19
268,3,2,383,400,17
271,9,4,394,400,6
273,3,0,401,406,5
270,0,2,393,409,16
272,1,2,401,409,8
274,4,1,401,412,11
275,9,1,401,412,11
276,3,0,408,413,5
277,0,4,410,415,5
280,9,1,413,419,6
261,8,3,380,419,39
264,5,3,381,419,38
265,6,3,381,419,38
266,7,3,381,419,38
269,2,3,385,419,34
278,1,0,411,422,11
279,4,0,413,422,9
282,0,1,416,424,8
290,4,1,423,431,8
286,8,2,420,431,11
287,9,2,420,431,11
291,0,2,432,437,5
281,3,3,414,438,24
285,6,3,420,438,18
288,7,3,421,438,17
283,2,0,420,441,21
284,5,0,420,441,21
289,1,0,423,441,18
292,4,1,433,442,9
294,9,1,433,442,9
300,5,2,442,447,5
293,8,0,433,448,15
304,5,0,448,453,5
305,8,2,449,454,5
295,0,3,438,456,18
296,3,3,439,456,17
297,6,3,439,456,17
298,7,3,439,456,17
299,1,4,442,460,18
302,4,4,443,460,17
303,9,4,443,460,17
311,7,1,458,463,5
309,3,2,457,463,6
306,5,0,454,464,10
307,8,0,455,464,9
301,2,3,443,465,22
308,0,3,457,465,8
313,4,4,462,473,11
310,6,3,458,475,17
316,7,3,464,475,11
321,4,2,474,480,6
315,3,1,464,482,18
317,5,1,465,482,17
318,8,1,465,482,17
312,1,0,462,483,21
314,9,0,462,483,21
319,0,0,466,483,17
320,2,0,466,483,17
328,0,4,484,489,5
327,8,0,483,490,7
323,7,2,480,493,13
325,3,2,483,493,10
332,0,3,490,495,5
333,8,0,491,497,6
336,0,2,496,501,5
334,3,3,494,501,7
337,8,3,498,506,8
339,3,0,502,507,5
338,0,4,502,512,10
340,8,0,507,518,11
341,3,0,508,518,10
322,6,1,477,518,41
324,4,1,481,518,37
326,5,1,483,518,35
329,1,1,484,518,34
330,2,1,484,518,34
331,9,1,484,518,34
342,0,3,513,518,5
335,7,1,494,527,33
346,3,1,519,527,8
345,2,0,519,528,9
348,5,0,519,528,9
349,6,4,519,528,9
351,9,4,519,528,9
352,3,4,528,533,5
354,2,1,529,534,5
343,0,3,519,537,18
344,1,3,519,537,18
347,4,3,519,537,18
350,8,3,519,537,18
355,5,0,529,539,10
356,6,0,529,539,10
358,3,1,534,544,10
359,2,1,536,544,8
360,0,0,538,545,7
353,7,3,528,547,19
357,9,3,529,547,18
362,4,4,538,547,9
363,8,4,538,547,9
372,9,2,548,555,7
365,6,3,543,557,14
366,2,3,545,557,12
373,9,4,556,561,5
361,1,1,538,562,24
364,5,1,541,562,21
367,3,1,545,562,17
369,4,0,548,566,18
370,7,0,548,566,18
371,8,0,548,566,18
368,0,1,546,567,21
375,6,2,560,567,7
378,3,4,563,569,6
380,4,1,567,573,6
376,9,3,562,573,11
377,1,3,563,573,10
383,6,4,569,574,5
374,2,0,558,575,17
379,5,0,563,575,12
389,2,1,576,581,5
381,7,3,568,582,14
386,4,3,574,582,8
387,9,0,574,584,10
390,6,0,576,584,8
382,0,2,569,588,19
384,3,2,570,588,18
385,8,2,570,588,18
393,4,4,583,589,6
395,6,1,585,590,5
388,1,3,576,591,15
392,2,3,582,591,9
398,3,1,590,597,7
397,0,2,590,599,9
399,4,2,590,599,9
400,8,3,590,600,10
401,6,3,591,600,9
391,5,0,580,602,22
394,7,0,584,602,18
396,9,0,585,602,17
411,9,4,603,610,7
402,1,0,592,611,19
403,2,0,597,611,14
404,3,3,598,618,20
406,4,3,600,618,18
408,8,3,601,618,17
413,1,2,612,619,7
412,9,4,611,620,9
414,2,4,612,620,8
405,0,1,600,621,21
407,6,1,601,621,20
409,5,1,603,621,18
410,7,1,603,621,18
417,8,0,619,624,5
416,4,2,619,624,5
418,1,3,620,625,5
415,3,4,619,625,6
423,6,1,623,628,5
421,5,3,622,630,8
426,8,1,625,633,8
420,2,2,622,633,11
422,0,2,623,633,10
428,1,3,629,635,6
433,8,4,634,641,7
419,9,0,621,642,21
424,7,0,624,642,18
425,4,0,625,642,17
430,5,1,631,642,11
432,2,1,634,642,8
427,3,2,626,643,17
429,6,2,629,643,14
439,7,1,643,648,5
434,1,2,636,648,12
437,4,4,643,652,9
441,3,4,644,652,8
431,0,0,634,653,19
440,9,0,643,653,10
442,6,1,650,657,7
445,3,2,653,660,7
435,8,3,642,661,19
436,2,3,643,661,18
438,5,3,643,661,18
448,9,1,656,662,6
449,6,0,658,663,5
452,5,3,662,670,8
443,7,4,650,670,20
444,1,4,651,670,19
446,4,4,653,670,17
447,0,4,654,679,25
450,3,4,661,679,18
457,4,1,671,680,9
459,7,1,671,680,9
456,1,3,671,680,9
458,5,3,671,680,9
451,2,0,662,681,19
453,8,0,662,681,19
454,9,0,663,681,18
455,6,0,664,681,17
462,1,2,681,687,6
460,0,0,680,691,11
468,8,0,682,691,9
464,5,1,681,691,10
467,6,1,682,691,9
470,1,4,690,696,6
473,6,1,692,697,5
471,0,0,692,698,6
472,5,2,692,701,9
474,8,2,692,701,9
475,1,0,698,703,5
476,6,1,698,704,6
477,0,4,699,705,6
478,5,1,703,714,11
481,6,1,705,714,9
480,8,2,704,715,11
482,0,2,706,715,9
461,3,3,680,716,36
463,4,3,681,716,35
465,7,3,681,716,35
466,2,3,682,716,34
469,9,3,682,716,34
485,0,2,716,721,5
488,3,0,717,723,6
483,5,4,715,733,18
484,6,4,715,733,18
486,8,4,716,733,17
479,1,3,704,734,30
487,2,3,717,734,17
490,7,3,717,734,17
494,5,1,734,739,5
495,6,0,734,743,9
496,8,0,734,743,9
500,5,0,740,748,8
489,4,4,717,751,34
491,0,4,723,751,28
493,9,4,727,751,24
492,3,3,724,754,30
497,1,3,735,754,19
499,7,3,735,754,19
506,9,1,752,758,6
498,2,4,735,760,25
502,8,4,744,760,16
504,0,0,752,761,9
505,4,0,752,761,9
501,6,3,744,763,19
503,5,3,749,763,14
507,1,1,755,764,9
513,0,3,762,768,6
515,5,1,764,769,5
509,3,4,757,772,15
514,4,4,762,772,10
517,1,3,767,774,7
518,0,1,769,776,7
508,7,0,755,779,24
510,9,0,759,779,20
511,2,0,761,779,18
512,8,0,761,779,18
521,4,2,774,779,5
522,1,3,775,780,5
523,0,1,777,782,5
525,4,3,780,785,5
527,1,1,781,787,6
516,6,4,765,790,25
519,5,4,770,790,20
520,3,4,773,790,17
531,4,3,786,791,5
535,6,0,791,796,5
533,3,2,791,797,6
532,1,3,788,800,12
536,4,3,792,800,8
539,1,1,801,807,6
537,6,3,797,819,22
538,3,3,798,819,21
540,4,3,801,819,18
543,4,3,820,825,5
524,2,4,780,825,45
526,7,4,780,825,45
528,8,4,781,825,44
529,9,4,781,825,44
530,0,4,783,825,42
534,5,4,791,825,34
551,9,1,826,831,5
547,4,3,826,835,9
550,8,3,826,835,9
552,9,1,832,837,5
555,9,1,838,843,5
541,1,4,808,843,35
542,3,4,820,843,23
544,6,4,820,843,23
545,0,0,826,844,18
546,2,0,826,844,18
548,5,0,826,844,18
549,7,0,826,844,18
553,4,3,836,845,9
554,8,3,837,845,8
558,9,2,844,853,9
563,7,2,845,853,8
560,2,1,845,854,9
557,6,3,844,854,10
561,3,3,845,854,9
556,1,4,844,854,10
559,0,4,845,854,9
569,1,3,855,861,6
562,5,0,845,863,18
564,4,0,846,863,17
565,8,0,846,863,17
566,7,1,854,864,10
572,6,1,855,864,9
567,9,2,854,866,12
570,2,2,855,866,11
577,6,3,865,874,9
578,7,3,865,874,9
574,4,1,864,876,12
579,9,1,867,876,9
582,7,2,875,880,5
580,2,3,868,883,15
581,6,3,875,883,8
585,7,1,881,886,5
586,2,2,884,889,5
588,7,2,887,894,7
589,2,1,890,895,5
568,0,0,855,898,43
571,3,0,855,898,43
573,1,0,862,898,36
575,5,0,864,898,34
576,8,0,864,898,34
591,2,4,896,901,5
583,9,3,878,903,25
584,4,3,881,903,22
587,6,3,884,903,19
593,1,2,899,906,7
590,7,0,895,907,12
595,5,0,899,907,8
597,2,3,902,908,6
592,0,1,899,909,10
594,3,4,899,910,11
596,8,4,899,910,11
601,5,0,908,914,6
598,4,2,904,916,12
600,9,2,907,916,9
602,7,3,908,917,9
603,1,3,909,917,8
604,2,1,909,922,13
605,0,1,912,922,10
609,4,2,917,922,5
599,6,4,906,922,16
607,8,4,913,922,9
606,3,3,912,926,14
608,5,3,916,926,10
614,2,1,923,928,5
616,6,4,923,928,5
619,5,2,927,932,5
610,1,0,918,936,18
611,7,0,918,936,18
612,9,0,918,936,18
620,2,1,930,938,8
624,7,2,937,942,5
613,0,3,923,944,21
617,8,3,923,944,21
618,3,3,927,944,17
615,4,0,923,945,22
621,6,0,930,945,15
631,4,0,946,956,10
630,0,2,946,957,11
632,6,2,946,957,11
623,1,4,937,959,22
625,9,4,937,959,22
626,2,4,942,959,17
622,5,3,933,962,29
627,7,3,943,962,19
628,3,3,945,962,17
636,1,1,960,966,6
637,2,0,960,969,9
638,9,0,960,969,9
634,0,3,958,971,13
639,7,3,963,971,8
641,1,2,967,974,7
643,2,1,970,975,5
629,8,4,945,977,32
633,4,4,957,977,20
635,6,4,958,977,19
646,7,0,972,978,6
645,0,2,972,980,8
642,5,3,967,981,14
644,9,3,970,981,11
647,2,0,977,983,6
650,6,2,979,987,8
640,3,4,964,987,23
649,4,4,979,987,8
652,0,1,981,990,9
653,7,1,981,990,9
648,1,3,978,990,12
651,8,3,979,990,11
658,4,2,988,993,5
662,7,0,991,996,5
655,2,1,986,997,11
