task_id,user_id,server_id,generation_time,completion_time,latency
9,9,4,0,5,5
8,8,2,0,6,6
1,1,0,0,9,9
3,3,0,0,9,9
10,8,4,8,13,5
13,3,2,10,15,5
11,9,0,8,17,9
0,0,1,0,18,18
5,5,1,0,18,18
6,6,1,0,18,18
2,2,3,0,18,18
4,4,3,0,18,18
7,7,3,0,18,18
20,5,4,19,26,7
23,5,3,28,33,5
14,8,0,15,37,22
15,3,0,16,37,21
16,9,0,18,37,19
22,7,0,19,37,18
24,5,2,34,41,7
25,3,0,38,47,9
26,7,0,38,47,9
27,8,2,38,51,13
28,9,2,38,51,13
12,1,1,10,54,44
17,0,1,19,54,35
18,2,1,19,54,35
19,4,1,19,54,35
21,6,1,19,54,35
29,5,0,42,56,14
31,7,0,48,56,8
33,9,2,52,57,5
30,3,4,48,57,9
32,8,3,52,58,6
38,6,0,56,61,5
35,1,1,55,61,6
37,4,2,55,63,8
42,9,1,58,71,13
45,6,1,62,71,9
46,4,2,64,71,7
41,3,3,58,71,13
44,1,3,62,71,9
48,3,1,72,81,9
49,4,1,72,81,9
50,6,3,72,81,9
51,9,3,72,81,9
53,4,0,82,88,6
34,0,4,55,93,38
36,2,4,55,93,38
39,5,4,57,93,36
40,7,4,57,93,36
43,8,4,59,93,34
56,4,0,89,95,6
52,3,3,82,100,18
54,6,3,82,100,18
55,9,3,82,100,18
60,7,2,94,103,9
61,8,2,94,103,9
47,1,4,72,103,31
59,5,4,94,103,9
63,3,0,101,106,5
57,0,1,94,113,19
58,2,1,94,113,19
62,4,1,96,113,17
65,9,2,101,122,21
66,1,2,104,122,18
67,5,2,104,122,18
68,7,2,104,122,18
71,0,0,114,124,10
72,2,0,114,124,10
73,4,2,114,131,17
76,9,2,123,131,8
64,6,1,101,134,33
69,8,1,104,134,30
70,3,1,107,134,27
77,1,2,124,149,25
79,2,2,125,149,24
81,9,2,132,149,17
86,2,0,150,156,6
85,1,2,150,159,9
87,9,2,150,159,9
88,2,3,158,164,6
89,1,0,160,169,9
90,9,0,160,169,9
74,5,1,123,169,46
75,7,1,123,169,46
78,0,1,125,169,44
80,4,1,132,169,37
82,3,1,135,169,34
83,6,1,135,169,34
84,8,1,135,169,34
91,2,4,165,170,5
93,1,2,170,180,10
95,4,2,170,180,10
103,4,0,181,186,5
92,0,3,170,188,18
94,3,3,170,188,18
97,6,3,170,188,18
99,8,3,170,188,18
96,5,4,170,188,18
98,7,4,170,188,18
100,9,4,170,188,18
101,2,4,171,188,17
107,3,4,189,195,6
102,1,3,181,197,16
108,5,3,189,197,8
109,6,1,189,198,9
112,9,1,189,198,9
113,3,2,196,201,5
115,5,3,198,208,10
116,6,3,199,208,9
114,1,2,198,210,12
117,9,2,199,210,11
120,6,2,209,217,8
118,3,3,202,218,16
119,5,3,209,218,9
121,1,3,211,223,12
104,4,0,187,224,37
105,0,0,189,224,35
106,2,0,189,224,35
110,7,0,189,224,35
111,8,0,189,224,35
124,3,4,219,229,10
125,5,4,219,229,10
131,8,2,225,232,7
132,3,3,230,239,9
133,5,3,230,239,9
134,8,2,234,240,6
126,1,4,224,240,16
129,4,4,225,240,15
136,5,1,240,246,6
138,4,4,241,246,5
141,5,1,247,252,5
135,3,3,240,258,18
137,1,3,241,258,17
139,8,3,241,258,17
122,9,0,211,259,48
123,6,0,218,259,41
127,0,0,225,259,34
128,2,0,225,259,34
130,7,0,225,259,34
142,5,2,253,259,6
149,6,4,260,265,5
152,6,3,267,273,6
143,1,2,259,277,18
145,8,2,259,277,18
151,9,2,260,277,17
153,6,3,274,279,5
154,1,1,278,283,5
158,1,4,284,289,5
156,9,3,278,291,13
157,6,3,280,291,11
140,4,0,247,294,47
144,3,0,259,294,35
146,0,0,260,294,34
147,2,0,260,294,34
148,5,0,260,294,34
150,7,0,260,294,34
159,1,1,290,295,5
160,6,3,292,297,5
165,5,2,295,300,5
163,3,3,295,302,7
170,6,2,302,307,5
169,5,3,301,308,7
155,8,0,278,313,35
161,9,0,292,313,21
162,2,0,295,313,18
167,0,0,296,313,17
164,4,4,295,313,18
166,7,4,295,313,18
168,1,4,296,313,17
172,6,3,308,315,7
180,8,2,315,320,5
175,1,3,314,324,10
178,7,3,314,324,10
181,6,2,323,330,7
171,3,0,303,331,28
173,5,0,309,331,22
176,2,0,314,331,17
174,0,1,314,332,18
177,4,1,314,332,18
179,9,1,314,332,18
185,6,3,331,336,5
189,0,3,333,341,8
192,0,3,343,348,5
186,2,2,332,350,18
190,4,2,333,350,17
191,9,2,333,350,17
193,6,1,343,351,8
194,0,1,349,356,7
196,4,2,351,356,5
197,9,4,351,359,8
195,2,3,351,360,9
198,6,3,352,360,8
199,0,1,357,362,5
182,8,0,324,366,42
183,1,0,325,366,41
184,7,0,326,366,40
187,3,0,332,366,34
188,5,0,332,366,34
202,2,1,361,368,7
204,0,2,363,370,7
208,7,3,367,372,5
206,3,4,367,372,5
205,1,2,367,380,13
210,0,2,371,380,9
213,7,1,373,381,8
211,2,3,371,385,14
212,3,3,373,385,12
214,0,1,381,390,9
216,7,1,382,390,8
218,3,3,387,393,6
217,2,1,386,396,10
200,4,0,357,402,45
201,9,0,360,402,42
203,6,0,361,402,41
207,5,0,367,402,35
209,8,0,367,402,35
219,7,3,391,402,11
220,0,3,392,402,10
222,2,1,398,405,7
223,0,3,403,408,5
225,5,4,403,410,7
230,2,3,406,415,9
215,1,0,382,420,38
221,3,0,394,420,26
228,8,0,403,420,17
229,9,0,403,420,17
233,2,3,416,421,5
232,0,4,414,421,7
224,4,1,403,423,20
226,6,1,403,423,20
227,7,1,403,423,20
238,0,2,422,427,5
231,5,1,412,429,17
235,3,0,421,430,9
239,2,0,422,430,8
234,1,4,421,430,9
237,9,4,421,430,9
236,8,3,421,434,13
241,6,3,424,434,10
240,4,0,424,440,16
244,5,0,430,440,10
249,8,3,437,442,5
251,5,2,441,447,6
243,0,1,429,448,19
246,2,1,431,448,17
248,9,1,431,448,17
242,7,4,425,448,23
245,1,4,431,448,17
247,3,4,431,448,17
250,4,3,441,449,8
257,2,3,449,460,11
261,4,3,450,460,10
252,6,4,442,468,26
259,7,4,449,468,19
260,9,4,449,468,19
262,4,3,461,473,12
263,2,4,462,477,15
266,9,4,469,477,8
264,6,2,469,479,10
265,7,2,469,479,10
269,9,0,478,483,5
268,2,3,478,483,5
253,8,1,443,484,41
254,5,1,448,484,36
255,0,1,449,484,35
256,1,1,449,484,35
258,3,1,449,484,35
267,4,2,474,485,11
270,7,0,480,488,8
276,3,3,485,492,7
274,0,4,485,494,9
277,5,4,485,494,9
275,1,2,485,495,10
278,8,2,485,495,10
283,5,3,495,501,6
280,7,0,491,502,11
281,3,0,493,502,9
271,6,1,481,502,21
272,2,1,484,502,18
273,9,1,484,502,18
284,1,4,496,504,8
286,5,2,502,511,9
290,7,2,503,511,8
287,2,4,503,511,8
282,0,0,495,520,25
288,3,0,503,520,17
289,6,0,503,520,17
279,4,1,486,520,34
285,8,1,496,520,24
291,9,1,503,520,17
293,2,4,512,520,8
298,3,2,521,528,7
295,7,1,513,538,25
300,6,1,521,538,17
302,9,1,521,538,17
292,1,0,510,539,29
294,5,0,513,539,26
299,4,0,521,539,18
296,0,3,521,539,18
297,2,3,521,539,18
301,8,3,521,539,18
303,3,3,533,548,15
308,1,3,540,548,8
304,6,4,539,549,10
310,4,4,540,549,9
305,7,0,539,550,11
312,8,0,540,550,10
313,1,1,549,558,9
316,6,1,550,558,8
306,9,2,539,558,19
307,0,2,540,558,18
309,2,2,540,558,18
311,5,2,540,558,18
314,3,4,549,558,9
315,4,4,550,558,8
323,5,3,559,564,5
321,3,0,559,568,9
322,4,0,559,568,9
319,1,4,559,569,10
326,0,4,560,569,9
327,5,3,567,573,6
328,3,4,569,578,9
332,3,2,579,584,5
329,4,0,569,588,19
330,0,0,570,588,18
331,1,0,570,588,18
334,3,2,585,590,5
317,8,1,551,594,43
318,7,1,553,594,41
320,2,1,559,594,35
324,6,1,559,594,35
325,9,1,559,594,35
333,5,0,580,597,17
337,4,0,589,597,8
338,3,2,591,598,7
335,0,3,589,598,9
336,1,3,589,598,9
339,2,4,595,606,11
341,7,4,595,606,11
343,8,1,597,608,11
346,0,1,599,608,9
351,2,4,609,614,5
342,9,0,595,616,21
345,5,0,598,616,18
348,3,0,599,616,17
340,6,3,595,616,21
344,4,3,598,616,18
347,1,3,599,616,17
353,2,4,615,620,5
350,0,1,609,621,12
352,8,1,609,621,12
349,7,0,608,625,17
358,6,0,617,625,8
359,9,2,618,625,7
357,5,4,617,625,8
360,2,0,621,634,13
362,8,0,623,634,11
354,1,3,617,637,20
355,3,3,617,637,20
356,4,3,617,637,20
370,3,0,638,643,5
361,0,4,622,643,21
363,5,4,626,643,17
364,7,4,626,643,17
367,2,1,635,644,9
368,8,1,635,644,9
365,9,3,626,647,21
366,6,4,627,652,25
371,4,4,638,652,14
374,5,0,644,653,9
376,7,0,645,653,8
369,1,1,638,653,15
377,8,1,645,653,8
372,0,3,644,656,12
373,3,3,644,656,12
375,2,4,645,659,14
383,7,1,654,663,9
384,8,1,654,663,9
386,3,4,658,664,6
379,4,0,653,672,19
381,1,0,654,672,18
382,5,0,654,672,18
388,2,4,665,674,9
390,3,4,666,674,8
378,9,3,650,675,25
380,6,3,653,675,22
385,0,3,657,675,18
392,4,4,673,679,6
395,3,2,675,680,5
389,7,3,665,680,15
398,9,4,676,684,8
387,8,0,664,691,27
391,1,0,673,691,18
393,5,0,673,691,18
401,7,4,684,692,8
394,2,1,675,694,19
396,0,1,676,694,18
397,6,1,676,694,18
404,5,3,692,701,9
405,8,3,692,701,9
409,6,4,695,701,6
403,1,1,692,703,11
406,7,1,693,703,10
412,8,2,702,707,5
399,4,0,680,710,30
400,3,0,682,710,28
402,9,0,685,710,25
414,7,2,706,712,6
415,8,4,708,713,5
410,5,1,702,717,15
407,0,3,695,719,24
408,2,3,695,719,24
411,6,3,702,719,17
421,5,1,718,723,5
419,7,3,713,725,12
413,1,0,705,727,22
420,8,0,714,727,13
423,0,1,721,729,8
416,3,2,711,731,20
417,4,2,712,731,19
418,9,2,712,731,19
426,7,1,727,734,7
429,0,4,730,740,10
430,4,4,732,740,8
427,1,2,728,743,15
431,9,2,732,743,11
422,6,0,720,746,26
424,5,0,725,746,21
425,2,0,726,746,20
428,8,0,728,746,18
434,0,3,741,746,5
433,7,1,735,752,17
437,9,1,744,752,8
435,4,4,741,752,11
436,1,4,744,752,8
446,9,2,753,758,5
444,4,3,753,759,6
432,3,0,734,765,31
438,2,0,747,765,18
441,0,0,748,765,17
447,9,3,759,769,10
448,4,3,760,769,9
449,0,2,766,772,6
451,3,4,767,772,5
453,9,2,770,778,8
455,3,2,775,783,8
456,9,3,779,784,5
439,5,1,747,788,41
440,8,1,747,788,41
442,6,1,748,788,40
443,1,1,753,788,35
445,7,1,753,788,35
457,3,4,784,790,6
459,1,0,789,798,9
461,6,0,789,798,9
462,7,3,789,799,10
460,5,4,789,799,10
463,8,4,789,799,10
466,5,2,800,805,5
450,2,1,766,806,40
452,4,1,770,806,36
454,0,1,773,806,33
458,9,1,785,806,21
468,7,0,800,808,8
471,0,2,807,812,5
472,2,3,807,812,5
464,3,1,794,815,21
470,5,1,806,815,9
474,9,0,807,816,9
465,1,4,799,817,18
467,6,4,800,817,17
469,8,4,800,817,17
475,7,3,810,826,16
479,5,3,816,826,10
477,2,2,813,827,14
482,6,2,818,827,9
484,5,2,827,833,6
485,7,3,827,833,6
476,0,0,813,835,22
480,9,0,817,835,18
483,8,0,818,835,17
487,6,1,828,835,7
473,4,4,807,835,28
478,3,4,816,835,19
481,1,4,818,835,17
489,7,3,834,839,5
492,4,1,836,842,6
496,9,2,837,843,6
491,3,0,836,845,9
495,0,0,837,845,8
490,1,3,836,848,12
493,6,3,836,848,12
499,9,1,844,850,6
500,0,3,846,853,7
486,2,4,828,854,26
488,5,4,834,854,20
494,8,4,836,854,18
503,9,2,851,856,5
507,5,2,855,861,6
497,7,0,840,863,23
498,4,0,844,863,19
501,3,0,846,863,17
505,0,1,854,863,9
506,2,1,855,863,8
504,1,3,852,864,12
508,8,3,855,864,9
510,5,2,862,867,5
502,6,0,849,872,23
511,0,0,864,872,8
512,2,4,864,873,9
514,4,4,864,873,9
519,0,0,873,880,7
521,2,2,874,881,7
524,2,3,882,888,6
523,0,4,881,891,10
526,0,0,892,897,5
525,2,4,889,898,9
509,9,1,857,899,42
513,3,1,864,899,35
515,7,1,864,899,35
516,1,1,865,899,34
517,8,1,865,899,34
528,2,3,899,905,6
527,0,2,898,908,10
531,7,2,900,908,8
518,5,1,871,917,46
520,6,1,873,917,44
522,4,1,874,917,43
532,8,1,900,917,17
529,1,4,900,918,18
530,3,4,900,918,18
533,9,4,900,918,18
534,0,0,909,919,10
536,7,0,909,919,10
537,4,4,918,923,5
535,2,1,909,926,17
540,8,1,918,926,8
538,5,0,918,927,9
545,7,4,920,928,8
544,0,1,920,931,11
548,8,0,927,932,5
546,4,3,924,935,11
547,2,3,927,935,8
539,6,2,918,937,19
541,1,2,919,937,18
542,3,2,919,937,18
543,9,2,919,937,18
554,4,0,936,941,5
551,7,3,932,945,13
553,2,3,936,945,9
557,6,0,938,946,8
559,4,1,942,947,5
561,7,0,946,952,6
562,4,4,948,953,5
549,5,2,929,955,26
550,0,2,932,955,23
552,8,2,933,955,22
556,3,2,938,955,17
564,7,1,953,959,6
565,4,4,954,959,5
555,1,3,938,963,25
558,9,3,938,963,25
560,2,3,946,963,17
563,6,2,953,964,11
566,0,2,956,964,8
567,3,4,956,964,8
571,7,0,960,967,7
568,8,1,956,968,12
570,4,1,960,968,8
569,5,2,959,971,12
573,2,3,964,973,9
575,0,3,965,973,8
572,1,4,964,973,9
577,6,4,965,973,8
585,6,4,974,979,5
583,1,3,974,980,6
581,5,0,972,983,11
584,2,0,974,983,9
589,5,3,985,990,5
586,6,4,980,990,10
587,1,4,981,990,9
588,2,4,984,996,12
