task_id,user_id,server_id,generation_time,completion_time,latency
1,1,0,0,9,9
8,8,0,0,9,9
2,2,4,0,10,10
3,3,4,0,10,10
0,0,3,0,18,18
5,5,3,0,18,18
7,7,3,0,18,18
4,4,1,0,19,19
6,6,1,0,19,19
9,9,1,1,19,18
10,1,4,10,19,9
11,8,4,10,19,9
12,2,3,11,23,12
15,5,4,19,28,9
19,6,4,20,28,8
16,7,0,19,29,10
17,1,0,20,29,9
20,8,2,20,29,9
21,9,2,20,29,9
22,2,4,27,37,10
24,6,4,29,37,8
13,3,1,11,38,27
14,0,1,19,38,19
18,4,1,20,38,18
25,1,0,30,39,9
27,8,0,30,39,9
23,5,2,29,39,10
26,7,2,30,39,9
28,9,1,30,43,13
29,2,3,38,43,5
31,0,0,39,44,5
35,5,3,40,48,8
30,6,4,38,48,10
36,7,4,40,48,8
39,0,4,45,55,10
42,6,1,49,58,9
43,7,1,49,58,9
32,3,2,39,58,19
33,4,2,39,58,19
34,1,2,40,58,18
37,8,2,40,58,18
40,9,3,45,58,13
41,5,3,49,58,9
44,0,4,56,63,7
49,6,1,59,64,5
47,4,3,59,64,5
53,0,3,65,70,5
54,4,4,65,74,9
55,6,4,65,74,9
56,0,3,71,76,5
45,1,0,59,77,18
48,5,0,59,77,18
50,7,0,59,77,18
52,9,0,59,77,18
38,2,2,44,77,33
46,3,2,59,77,18
51,8,2,59,77,18
58,6,3,75,81,6
63,5,0,78,83,5
57,4,2,75,86,11
61,2,2,78,86,8
65,8,3,78,88,10
60,1,4,78,89,11
64,7,4,78,89,11
68,5,0,85,90,5
59,0,1,77,96,19
62,3,1,78,96,18
66,9,1,78,96,18
74,5,0,91,97,6
77,9,0,97,102,5
76,3,3,97,102,5
67,6,4,82,107,25
70,2,4,88,107,19
72,1,4,90,107,17
79,3,3,103,112,9
80,9,3,103,112,9
78,5,4,98,112,14
82,6,2,108,113,5
83,1,0,109,115,6
69,4,1,87,115,28
71,8,1,89,115,26
73,7,1,90,115,25
75,0,1,97,115,18
85,5,2,113,118,5
87,6,3,114,119,5
81,2,1,108,120,12
84,3,4,113,123,10
86,9,4,113,123,10
93,5,2,119,124,5
88,0,0,116,127,11
91,4,0,118,127,9
92,7,3,118,128,10
94,6,3,120,128,8
101,6,0,129,134,5
97,9,2,124,134,10
98,5,2,125,134,9
95,2,3,121,137,16
99,0,3,128,137,9
105,9,2,135,141,6
89,1,4,116,141,25
90,8,4,117,141,24
96,3,4,124,141,17
103,5,3,135,142,7
104,6,1,135,143,8
110,8,3,142,147,5
106,0,2,138,150,12
107,2,2,138,150,12
100,4,4,128,150,22
102,7,4,129,150,21
111,9,0,142,151,9
112,5,0,143,151,8
108,1,1,142,153,11
109,3,1,142,153,11
114,8,3,148,153,5
115,0,2,151,156,5
123,8,2,154,162,8
121,1,0,154,163,9
122,3,0,154,163,9
126,1,2,164,169,5
113,6,4,145,169,24
116,2,4,151,169,18
118,7,4,151,169,18
117,4,1,151,171,20
119,5,1,152,171,19
120,9,1,152,171,19
124,0,0,162,173,11
125,8,0,163,173,10
130,6,2,170,175,5
131,7,4,170,175,5
127,3,1,164,180,16
132,4,1,172,180,8
138,7,3,176,181,5
137,6,2,176,182,6
134,9,4,172,184,12
135,0,4,174,184,10
136,8,1,174,185,11
140,4,3,181,186,5
128,1,0,170,191,21
129,2,0,170,191,21
133,5,0,172,191,19
139,3,2,181,191,10
141,7,2,182,191,9
142,6,3,183,191,8
146,4,4,187,194,7
144,9,1,185,195,10
145,8,1,186,195,9
153,4,3,195,200,5
154,8,1,196,201,5
150,5,0,192,202,10
151,6,0,192,202,10
155,9,3,197,205,8
160,9,0,206,211,5
157,8,1,202,212,10
159,6,1,203,212,9
156,4,3,202,214,12
158,5,3,203,214,11
162,6,1,213,222,9
163,8,1,213,222,9
143,0,2,185,226,41
147,1,2,192,226,34
148,2,2,192,226,34
149,3,2,192,226,34
152,7,2,192,226,34
166,6,3,223,228,5
164,4,1,215,231,16
165,5,1,215,231,16
168,0,0,227,233,6
161,9,2,212,235,23
167,8,2,223,235,12
170,2,4,227,236,9
172,7,4,227,236,9
176,5,2,234,245,11
178,9,2,236,245,9
177,8,0,236,246,10
180,7,0,237,246,9
169,1,3,227,248,21
171,3,3,227,248,21
173,6,3,229,248,19
174,4,4,233,254,21
175,0,4,234,254,20
179,2,4,237,254,17
181,5,0,246,255,9
183,7,0,247,255,8
182,9,2,246,256,10
184,8,2,247,256,9
187,1,1,252,258,6
186,3,4,251,260,9
188,0,2,255,263,8
189,2,3,255,265,10
190,4,3,255,265,10
193,8,1,257,267,10
194,1,1,259,267,8
199,4,3,266,271,5
185,6,0,250,273,23
191,5,0,256,273,17
192,7,0,256,273,17
196,9,1,263,273,10
195,3,2,262,273,11
197,0,2,264,273,9
201,8,4,269,274,5
205,5,4,274,279,5
200,1,0,268,282,14
208,9,0,274,282,8
202,4,1,272,283,11
209,8,1,275,283,8
206,6,3,274,283,9
207,7,3,274,283,9
214,6,3,284,289,5
210,5,1,282,290,8
198,2,2,266,291,25
203,0,2,274,291,17
204,3,2,274,291,17
213,4,4,284,293,9
215,7,4,284,293,9
218,5,1,291,296,5
222,4,2,294,299,5
211,1,0,283,301,18
212,9,0,283,301,18
216,8,0,284,301,17
223,7,4,295,301,6
224,5,1,298,303,5
227,7,1,302,308,6
217,6,3,290,310,20
219,0,3,292,310,18
220,2,3,292,310,18
221,3,3,292,310,18
225,4,4,300,310,10
229,9,4,302,310,8
226,1,2,302,311,9
228,8,2,302,311,9
230,5,0,304,314,10
232,0,1,311,318,7
237,1,4,312,318,6
235,4,0,311,319,8
231,7,3,309,328,19
233,2,3,311,328,17
234,3,3,311,328,17
240,1,4,319,328,9
241,5,4,319,328,9
236,9,2,311,330,19
238,6,2,312,330,18
239,8,2,312,330,18
244,1,1,329,334,5
246,3,3,329,335,6
251,9,4,331,338,7
252,1,1,336,341,5
254,9,3,339,344,5
255,1,1,342,348,6
242,0,2,320,348,28
243,4,2,321,348,27
247,5,2,329,348,19
250,8,2,331,348,17
245,2,0,329,349,20
248,7,0,329,349,20
249,6,0,331,349,18
253,3,2,336,354,18
256,9,0,345,355,10
260,5,4,349,358,9
264,7,4,350,358,8
266,9,0,357,363,6
257,0,1,349,367,18
258,1,1,349,367,18
263,6,1,350,367,17
267,5,2,359,368,9
268,7,2,359,368,9
259,4,3,349,368,19
261,8,3,349,368,19
262,2,3,350,368,18
269,9,2,364,374,10
274,4,4,369,374,5
271,1,0,368,377,9
276,7,0,369,377,8
273,2,3,369,381,12
277,8,3,369,381,12
281,7,4,378,383,5
278,4,2,375,384,9
279,9,2,375,384,9
265,3,1,357,385,28
270,0,1,368,385,17
272,6,1,368,385,17
280,1,3,378,386,8
286,9,3,385,391,6
283,8,0,382,392,10
284,7,0,384,392,8
285,4,2,385,394,9
288,3,2,386,394,8
293,8,3,393,399,6
294,3,0,395,401,6
275,5,1,369,403,34
282,2,1,382,403,21
287,0,1,386,403,17
289,6,1,386,403,17
301,6,3,404,409,5
290,1,2,391,412,21
292,7,2,393,412,19
295,4,2,395,412,17
302,6,0,410,416,6
303,1,4,413,419,6
291,9,1,392,421,29
296,8,1,401,421,20
297,3,1,402,421,19
304,4,0,413,425,12
305,7,0,413,425,12
306,6,4,417,428,11
307,1,4,420,428,8
298,0,2,404,430,26
299,2,2,404,430,26
300,5,2,404,430,26
312,7,3,426,431,5
311,4,0,426,432,6
309,9,4,422,433,11
316,2,1,431,437,6
318,7,3,432,437,5
315,0,4,431,439,8
314,6,0,429,441,12
319,4,0,433,441,8
322,9,0,438,446,8
325,6,3,442,447,5
324,4,4,442,447,5
308,8,2,422,448,26
310,3,2,423,448,25
313,1,2,429,448,19
317,5,2,431,448,17
327,4,4,448,454,6
329,1,3,449,455,6
320,2,1,438,457,19
321,7,1,438,457,19
323,0,1,440,457,17
330,3,0,449,458,9
332,8,0,449,458,9
326,9,2,447,458,11
331,5,2,449,458,9
336,2,0,458,468,10
337,7,0,458,468,10
338,3,3,459,468,9
341,9,3,459,468,9
328,6,1,448,475,27
333,4,1,455,475,20
335,0,1,458,475,17
344,7,3,469,475,6
334,1,2,456,476,20
339,5,2,459,476,17
340,8,2,459,476,17
342,2,0,469,479,10
345,9,0,469,479,10
346,0,4,476,481,5
351,5,0,477,485,8
347,4,1,476,485,9
352,8,1,477,485,8
343,3,2,469,485,16
348,6,2,476,485,9
349,7,3,476,485,9
350,1,3,477,485,8
354,9,4,481,486,5
357,3,1,486,491,5
358,4,4,486,491,5
356,1,0,486,495,9
363,9,0,487,495,8
364,4,4,492,497,5
367,9,0,496,501,5
355,0,3,482,503,21
359,5,3,486,503,17
360,6,3,486,503,17
353,2,2,481,504,23
361,7,2,486,504,18
362,8,2,486,504,18
366,1,4,496,506,10
375,8,0,505,510,5
374,7,3,505,510,5
373,2,4,505,512,7
370,0,1,504,513,9
371,5,1,504,513,9
381,5,1,514,519,5
365,3,2,493,522,29
368,4,2,498,522,24
369,9,2,502,522,20
372,6,2,504,522,18
379,0,3,514,524,10
380,2,3,514,524,10
376,1,0,509,529,20
377,7,0,511,529,18
378,8,0,511,529,18
386,9,4,523,533,10
388,2,4,525,533,8
389,1,1,530,535,5
392,2,4,534,539,5
382,5,2,520,540,20
383,3,2,523,540,17
384,4,2,523,540,17
385,6,2,523,540,17
394,1,3,537,542,5
387,0,0,525,547,22
390,7,0,530,547,17
391,8,0,530,547,17
393,9,2,534,558,24
395,2,2,540,558,18
399,6,2,541,558,17
396,3,0,541,565,24
397,4,0,541,565,24
398,5,0,541,565,24
400,1,0,543,565,22
406,9,3,559,565,6
401,0,1,548,568,20
402,7,1,548,568,20
403,8,1,548,568,20
409,4,2,566,571,5
411,9,3,566,571,5
404,2,0,559,574,15
405,6,0,559,574,15
412,7,0,569,580,11
413,0,3,570,580,10
416,9,3,572,580,8
414,8,2,571,581,10
415,4,2,572,581,9
407,1,4,566,584,18
408,3,4,566,584,18
410,5,4,566,584,18
421,9,0,581,590,9
422,4,0,582,590,8
424,1,1,585,590,5
425,3,2,586,591,5
427,1,0,591,597,6
417,6,3,575,600,25
419,0,3,581,600,19
420,7,3,581,600,19
431,1,0,598,603,5
418,2,4,576,603,27
423,8,4,582,603,21
426,5,4,586,603,17
434,7,1,601,606,5
432,0,2,601,606,5
435,1,0,604,609,5
429,9,3,591,609,18
433,6,3,601,609,8
437,5,1,604,611,7
441,1,0,610,615,5
436,2,2,604,615,11
440,7,2,607,615,8
439,0,3,607,618,11
442,6,3,610,618,8
444,5,1,614,620,6
445,1,0,616,621,5
446,2,2,616,622,6
428,4,4,591,622,31
430,3,4,592,622,30
438,8,4,604,622,18
455,8,3,623,628,5
451,1,1,622,631,9
453,3,1,623,631,8
450,5,2,621,631,10
452,2,2,623,631,8
457,1,0,632,640,8
456,8,1,629,640,11
459,3,1,632,640,8
458,2,3,632,641,9
460,5,3,632,641,9
461,1,3,641,647,6
465,5,0,642,656,14
466,1,0,648,656,8
443,9,4,611,657,46
447,7,4,616,657,41
448,0,4,619,657,38
449,6,4,619,657,38
454,4,4,623,657,34
462,3,1,641,659,18
463,8,1,641,659,18
464,2,1,642,659,17
468,5,3,657,663,6
470,4,1,658,664,6
467,1,0,657,666,9
471,6,0,658,666,8
479,1,0,667,672,5
476,5,1,664,673,9
478,4,1,665,673,8
475,8,3,662,674,12
477,3,3,665,674,9
469,0,2,658,676,18
472,7,2,658,676,18
473,9,2,658,676,18
480,6,4,671,676,5
483,5,3,674,679,5
488,7,1,677,683,6
489,9,3,677,684,7
490,5,4,683,688,5
492,9,3,685,690,5
484,3,0,675,694,19
485,8,0,675,694,19
486,0,0,677,694,17
493,5,1,689,694,5
474,2,2,660,694,34
481,1,2,673,694,21
482,4,2,674,694,20
487,6,2,677,694,17
494,9,3,691,697,6
491,7,2,684,703,19
496,1,2,695,703,8
503,9,2,703,712,9
504,1,2,704,712,8
499,4,1,695,713,18
501,6,1,695,713,18
502,8,1,695,713,18
495,0,4,695,713,18
497,2,4,695,713,18
498,3,4,695,713,18
500,5,4,695,713,18
513,6,2,714,720,6
507,9,1,713,722,9
512,5,1,714,722,8
505,7,4,704,731,27
506,1,4,713,731,18
511,4,4,714,731,17
508,0,0,714,732,18
509,2,0,714,732,18
510,3,0,714,732,18
514,8,0,714,732,18
516,5,2,723,732,9
517,9,2,723,732,9
526,9,0,733,738,5
519,4,1,732,742,10
525,8,1,733,742,9
528,4,0,743,748,5
529,8,1,743,748,5
518,1,2,732,750,18
520,7,2,732,750,18
522,2,2,733,750,17
523,3,2,733,750,17
515,6,4,721,751,30
521,0,4,733,751,18
524,5,4,733,751,18
535,7,2,751,756,5
538,6,1,752,760,8
540,6,2,761,767,6
530,4,3,749,768,19
531,8,3,749,768,19
532,1,3,751,768,17
533,2,3,751,768,17
527,9,4,739,769,30
534,3,4,751,769,18
536,0,4,752,769,17
537,5,4,752,769,17
542,1,1,769,774,5
541,6,2,768,778,10
546,0,2,770,778,8
539,7,3,758,787,29
543,2,3,769,787,18
545,8,3,769,787,18
547,3,3,770,787,17
544,4,0,769,788,19
548,5,0,770,788,18
549,9,0,770,788,18
550,1,4,778,788,10
552,6,4,779,788,9
551,0,0,779,797,18
553,2,0,788,797,9
557,1,3,789,798,9
558,4,3,789,798,9
554,3,1,788,806,18
555,7,1,788,806,18
559,5,1,789,806,17
556,8,4,788,806,18
560,6,4,789,806,17
561,9,4,789,806,17
562,0,0,798,807,9
563,2,0,798,807,9
564,1,2,799,809,10
565,4,2,800,809,9
571,9,0,807,813,6
568,6,1,807,814,7
566,3,3,807,816,9
567,5,3,807,816,9
574,4,0,810,822,12
576,9,0,814,822,8
577,6,1,815,825,10
578,3,1,817,825,8
569,7,4,807,825,18
570,8,4,807,825,18
572,0,4,808,825,17
573,2,4,808,825,17
575,1,3,811,827,16
579,5,3,817,827,10
581,9,1,823,834,11
586,7,1,826,834,8
582,0,4,826,836,10
587,8,4,826,836,10
583,2,2,826,844,18
584,3,2,826,844,18
585,6,2,826,844,18
592,0,0,837,846,9
593,8,0,837,846,9
580,4,3,823,846,23
588,1,3,828,846,18
589,5,3,828,846,18
590,7,2,835,849,14
594,2,0,845,851,6
591,9,3,835,855,20
601,8,3,847,855,8
596,6,4,845,855,10
597,0,4,847,855,8
607,9,2,856,861,5
595,3,1,845,864,19
598,1,1,847,864,17
599,4,1,847,864,17
600,5,1,847,864,17
605,6,0,856,865,9
606,8,0,856,865,9
603,7,4,852,865,13
604,0,4,856,865,9
608,9,3,862,867,5
609,1,3,865,872,7
602,2,1,852,873,21
612,5,1,865,873,8
610,3,4,865,874,9
616,8,4,866,874,8
621,3,0,875,882,7
618,1,4,873,883,10
619,2,4,874,883,9
611,4,2,865,885,20
613,0,2,866,885,19
617,9,2,868,885,17
625,2,4,884,889,5
614,6,1,866,892,26
615,7,1,866,892,26
622,8,1,875,892,17
627,4,3,886,892,6
623,3,0,883,893,10
624,1,0,884,893,9
620,5,2,874,896,22
628,9,2,887,896,9
626,0,4,886,896,10
631,6,1,893,898,5
635,3,3,894,899,5
629,2,2,890,905,15
637,5,2,897,905,8
639,3,2,902,910,8
630,4,0,893,912,19
633,8,0,893,912,19
634,1,0,894,912,18
641,2,3,906,912,6
632,7,4,893,915,22
636,0,4,897,915,18
638,9,4,897,915,18
644,1,2,913,918,5
640,6,0,902,920,18
645,2,3,913,922,9
646,4,3,913,922,9
651,1,2,919,924,5
653,2,1,923,928,5
650,9,3,916,928,12
652,6,0,921,931,10
654,4,0,923,931,8
655,1,3,927,933,6
656,2,1,929,938,9
657,9,1,929,938,9
660,1,2,934,940,6
658,4,3,932,943,11
659,6,3,932,943,11
661,2,1,939,944,5
663,1,1,941,949,8
642,5,4,906,950,44
643,3,4,911,950,39
647,8,4,913,950,37
648,0,4,916,950,34
649,7,4,916,950,34
668,0,1,951,956,5
662,9,4,939,959,20
670,5,4,951,959,8
669,3,2,951,960,9
671,7,2,951,960,9
667,1,3,950,960,10
672,8,3,951,960,9
664,4,0,944,963,19
665,6,0,944,963,19
666,2,0,945,963,18
675,9,1,960,965,5
677,3,2,961,970,9
679,8,2,961,970,9
674,5,4,960,970,10
676,1,4,961,970,9
683,9,3,967,973,6
686,5,1,971,976,5
680,4,2,964,979,15
682,2,2,966,979,13
688,9,4,974,979,5
673,0,0,957,981,24
678,7,0,961,981,20
681,6,0,964,981,17
685,3,3,971,983,12
687,8,3,971,983,12
689,5,4,978,984,6
695,7,4,982,989,7
684,1,0,971,990,19
692,9,0,980,990,10
693,0,1,982,991,9
694,6,1,982,991,9
691,4,3,980,992,12
697,8,3,984,992,8
690,2,2,980,994,14
698,5,2,985,994,9
696,3,0,984,997,13
